ほ	逋	捕	哮	歩	帆	埔	補	咆	惚	褒	葡	鋪	乾	舗	耄	舖	吼	畝	吠	穂	彫	干	匍	葆	襃	穗	輔	甫	圃	堡	愡	恍	放	黼	賞	脯	掘	鯆	誉	浦	火	保	蒲	餔	譽	欲	哺
へ	邊	經	減	戸	歴	辺	舳	邉	経	屁
ふ	趺	扶	畉	斑	苻	富	浮	歩	經	俛	伏	郛	鮒	拭	埠	觝	風	蹈	降	鋪	噴	舗	府	柎	麸	孵	触	冨	殖	賦	芙	榑	腑	匐	麩	符	譜	仆	深	葺	阜	溥	斧	踏	敷	咐	践	臥	父	俘	夫	觸	経	生	吹	附	老	罘	蜉	負	振	賻	訃	付	婦	傅	桴	巫	赴	怖	布	鯆	拊	増	不	履	坿	腐	膚	更	俯	普	孚	誣
ひ	祕	鞁	陳	皮	誹	轢	毘	暃	扉	索	痞	罷	肥	乾	貔	譬	冷	鞴	俾	惹	魅	桧	披	梭	疲	碾	否	比	飛	鄙	氷	秕	彼	昜	干	髀	妃	批	霏	蓖	丕	彈	弾	豼	秘	斐	裨	匪	碑	被	簸	菲	檜	引	避	牽	紕	贔	卑	痺	挽	放	脾	退	樋	悲	婢	庇	杼	泌	陽	匕	腓	狒	費	妣	蜚	日	火	砒	非	朏	緋	灯	曳	轡	臂
は	琶	頗	羞	刷	貼	張	掃	玻	栄	叭	暎	愧	播	刃	齒	榮	怕	菷	刄	芭	慙	佩	坡	膨	歯	爬	葩	穿	着	匍	腫	剥	波	端	発	陂	晴	映	覇	果	羽	碆	禿	派	跳	簸	生	填	馳	發	把	捌	霸	嵌	破	撥	這	帶	爆	葉	脹	履	笆	巴	耻	跛	垪	杷	帚	菠	恥	食	吐
ほん	犇	翻	笨	反	奔	本	飜	叛	畚
ほろ	亡	幌	滅	袰	保呂	母衣
ほり	壕	堀	捕吏	濠
ほら	法螺	洞
ほや	海鞘
ほま	誉	譽
ほぼ	保母	保姆	略
ほほ	頬
ほぶ	歩武
ほふ	保父	屠
ほひ	補肥
ほの	仄
ほね	骨
ほど	歩度	解	程
ほと	殆
ほて	火照
ほづ	保津
ほつ	発
ほっ	法	発	發	欲
ほだ	絆
ほぞ	臍
ほそ	細
ほじ	穿	保持
ほし	干し	星	☆	＊	欲し	※	★	欲
ほざ	帆座
ほさ	保佐	補佐	輔佐
ほご	反故	保護	補語	反古
ほこ	矛	誇	桙	戈	戟	鉾
ほぐ	解
ほく	蹼	瀑	攵	殕	攴	北
ほき	補機	補記
ほが	朖	朗
ほか	他	外
ほお	朴	放	頬
ほう	匏	袍	報	蔀	捧	方	炮	俸	飽	弸	豊	萠	琺	咆	寳	惚	彷	褒	瀑	蓬	舫	鋒	膀	硼	繃	法	苞	麭	豐	砲	匚	呆	堋	泡	棚	泙	胞	襃	棒	怦	抔	寶	髣	朋	訪	朴	皰	邦	逢	幇	疱	奉	庖	篷	勹	焙	包	縫	澎	鳳	垉	萌	鞄	峰	放	封	磅	峯	崩	烽	迸	彭	魴	蜂	宝	抛	枋	烹	保	鴇	鵬	芳	倣	褓	抱
ほい	補遺
へん	褊	邊	駢	返	蝙	辺	篇	邉	翩	扁	騙	偏	変	片	諞	胼	編	貶	變	遍
へり	邊	辺	邉	縁
へら	箆	減ら	篦
へや	廳	部屋	廰
へみ	逸見
へび	巳	蛇
へな	埴
へつ	丿	暼
へだ	隔	戸田
へた	蔕	戸田	下手	蒂
へそ	巻子	綜麻	臍
へご	竹畚
へこ	凹
へき	劈	闢	璧	甓	僻	日置	辟	碧	躄	癖	壁
へい	蔽	炳	陛	箆	弊	幤	并	柄	嬖	平	坪	幣	兵	屏	聘	閇	病	閉	並	敝	丙	塀	瓶	併	睥	斃	娉	餅	竝
ふん	奮	賁	吩	扮	氛	′	濆	枌	噴	吻	汾	刎	分	芬	憤	粉	糞	忿	紛	焚	雰	墳
ふわ	腑分	不和	不破	付和
ふろ	風炉	風呂
ふれ	触れ	振れ
ふる	奮	揮	顫	旧	故	篩	振	舊	古	震
ふり	降り	不利	振り	振	不離
ふよ	付与	賦与
ふゆ	冬
ふや	増や	殖や
ふむ	不向
ふみ	文	踏み	不味	史	章	芙美	郁	二三
ふま	踏ま
ふぼ	父母
ふほ	付保
ふぶ	吹雪	布武	乱吹
ふび	不備
ふは	不破
ふの	布野
ふね	艦	船	舩	舟
ふぬ	腑抜
ふな	鮒	不慣	船	舩	舟
ふと	太	富戸	不図
ふで	筆
ふつ	仏	弗	拂	佛	髴	彿	祓	払	沸	怫	黻	布津
ふち	附置	布置	付置	負値	渕	不知	渊	不治	縁	付値	淵	扶持
ふだ	簡	布田	札
ふた	弍	双	盖	葢	二	蓋
ふそ	父祖
ふせ	布施	防	伏せ	拒
ふず	付図
ふじ	藤	不二	富士	不治	冨士	不時
ふし	伏	不死	父子	臥	節	浮子
ふざ	趺坐
ふさ	絃	總	鬱	惣	塞	房	総	相応
ふこ	封戸	巫蠱
ふけ	冨宅	普家	冨家	耽
ふぐ	河豚	不具	鰒
ふく	伏	袱	覆	服	幅	膨	匐	腹	箙	茯	復	蝠	吹	副	福	複	愎	富久	輻	輹	脹	馥	蔔	含	拭く
ふぎ	府議	不義	付議
ふき	不期	葺	苳	附記	不帰	吹	蕗	付記	不軌
ふか	鯊	付加	蒸	鱶	潭	負荷	附加	負化	深	賦課	孵化	府下	孚化	富家	浮華	更	不可
ふえ	吭	笛	不壊	鰾
ふう	富	風	瘋	殕	諷	夫	封	楓
ふい	不意	不入	巫医
ひん	品	稟	賓	嬪	斌	濱	顰	瀕	擯	頻	繽	彬	牝	蘋	殯	浜	禀	貧
ひわ	比和	干割	鶸	秘話	悲話
ひろ	裕	愽	紘	洪	比呂	絋	拓	宥	博	史	展	仞	太	寛	弘	拾	大	宏	仭	擴	泰	伯	尋	廣	洋	祐	浩	拡	広	啓	央	恕
ひれ	鰭
ひる	晝	昼	簸	怯	葫	蛭	蒜
ひり	非理
ひら	拓	比良	平	衡	片	開	啓
ひよ	日和
ひゆ	比喩	譬喩
ひや	冷	冷や	日焼
ひも	綬	紐
ひめ	媛	姫
ひみ	氷見
ひま	暇	隙	日増	蝦	閑
ひぶ	秘部	日歩
ひふ	火吹	非負	皮膚	被布
ひび	日々	皸	響	日日	罅	日比	皹
ひひ	比々	比比	狒狒	霏々	狒々	霏霏
ひば	比婆
ひの	日野	日延	火野	樋野
ひね	陳	撚	捫	拈	老成	捻
ひな	鄙	雛
ひど	酷	日取	肥土	非道
ひと	女	費途	一	史	孤	弌	独	他人	仁	獨	壱	均	１	等	壹	斉	1	人
ひで	秀	英	映	日照
ひづ	日付
ひつ	筆	謐	篳	匹	弼	畢	火付	必	蹕	疋	逼	泌	櫃
ひっ	筆	必
ひだ	飛騨	襞	肥田	日溜	樋田	飛田	肥立
ひた	日田	浸	漬
ひそ	祕	潜	砒素	濳	密	顰	秘	Arsenic	As	潛
ひぜ	火責	火攻
ひず	歪
ひじ	日出	秘事	肱	樋地	肘	臂
ひし	犇	蔆	拉	皮脂	秘史	◇	斐紙	柆	菱	彼此
ひざ	日射	日差	膝
ひさ	壽	拉	鬻	尚	寿	販	央	久
ひご	蜚語	籖	卑語	籤	庇護	肥後	飛語
ひこ	彦	曾孫	秘湖	比古
ひげ	鬚	卑下	髯	髭
ひけ	火消	引け
ひぐ	日暮
ひく	−	低	牽	攣	佗
ひぎ	秘技	秘戯	非義	秘儀
ひき	匹	引き	率	比企	日置	蟇	引	蟆	疋	挽	悲喜	曳
ひが	比嘉	僻	非我	日掛	日替	日変	彼我
ひか	皮下	控	悲歌	光
ひえ	冷え	稗
ひう	日宇
ひい	秀	非違	曾	贔	緋衣	火入
ひあ	乾上	干上
はん	范	斑	帆	絆	燔	繁	翻	汎	胖	幡	蕃	煩	範	頒	槃	笵	拌	判	坂	板	藩	反	旛	伴	繙	阪	瘢	釆	半	蟠	畔	泛	氾	搬	版	班	袢	潘	攀	販	般	叛	樊	凡	磐	飯	犯	膰	鈑
はろ	波呂
はれ	腫れ	晴	晴れ
はる	榛	青春	玄	遥	晴	遙	春	温	請	遼	治
はり	貼	張	播	榛	玻璃	針	鉤	蓁	鍼	梁
はら	肚	掃	拂	腹	禳	祓	孕	払	原	波羅
はよ	早
はゆ	映
はや	流行	逸	捷	鮠	頓	速	疾	早	囃
はも	羽茂	鱧
はめ	破目	羽目
はみ	馬銜	葉美
はま	濱	填	嵌	破魔	浜
はべ	侍
はぶ	羽振	省	埴生	土生	羽生
はふ	破風
はば	掵	難	幅	阻	巾
はは	母	義母
はの	羽野
はね	撥ね	跳ね	羽	翅	羽根
はぬ	歯脱
はに	羽仁	埴
はな	話	端	放	花	鼻	纏頭	離	塙	華	洟
はど	歯止
はと	鴿	鳩
はで	派手
はて	果て
はづ	彈	弾	勢	辱	外	恥
はつ	溌	醗	釟	癶	発	髪	發	初	鉢	捌	撥	秡	髮
はっ	葉っ	法	発	發
はち	鉢	捌	椀	８	蜂	八
はだ	肌	羽田	膚	開
はた	叩	旗	幟	幡	畑	側	秦	将	端	旙	旛	果	畠	圃	羽田	機	傍	波田	籏	波多	幡多
はぜ	鯊	枦	櫨	黄櫨
はせ	馳	長谷
はず	彈	弾	筈	勢	機	外	恥
はす	蓮	斜
はじ	土師	創	把持	弾	端	始	甫	初	耻	恥
はし	箸	走	梯	觜	端	枦	奔	迸	赱	橋
はさ	夾	挾	挟
はご	羽子
はこ	筥	箱	函	□	筐	運	葉子	箪	凾	匣
はげ	烈	剥げ	勵	禿	激	励	劇
はけ	刷毛	捌け
はぐ	爬具	逸
はく	箔	愽	薄	搏	岶	博	蘗	璞	泊	吐く	剥	擘	帛	粕	佰	狛	珀	白	亳	柏	拍	膊	魄	舶	栢	伯	迫	陌
はぎ	萩	端切	矧	脛	歯切
はき	杷木	覇気	破毀	破棄
はが	芳賀	剥	波賀	羽賀
はか	破瓜	図	企	測	諮	計	量	圖	謀	墓
はお	羽織
はえ	南風	蠅	生え	蝿
はい	旆	珮	俳	肺	癈	拝	坏	拜	灰	佩	杯	這入	吠	徘	牌	悖	碚	埴	輩	琲	裴	胚	敗	廃	背	入	排	湃	孛	這	沛	稗	廢	擺	睥	憊	盃	配	霈
ほんよ	本読
ほんや	本屋
ほんめ	本目
ほんむ	本務
ほんま	本馬	本間
ほんぽ	本圃	本舗
ほんぷ	本譜
ほんぶ	本部	本降
ほんば	本場	奔馬
ほんね	本音
ほんぬ	本有
ほんど	本泊	本土	本渡
ほんと	本飛	本当
ほんて	本手
ほんち	本地
ほんだ	誉田	本田	本多
ほんそ	本訴
ほんじ	翻字	本字	本地
ほんし	本志	本紙	本旨	本誌	本四
ほんご	本語
ほんけ	本家
ほんぎ	本極	本紀	本義	本決
ほんき	本気	本機	本期
ほんか	本歌	本科
ほんう	本有
ほんい	翻意	本位	本意
ほろよ	微酔
ほろう	歩廊
ほれぼ	惚れ惚
ほれこ	惚れ込
ほれい	保冷
ほるい	堡塁
ほりょ	捕虜
ほりべ	堀部	堀辺
ほりば	堀場
ほりの	堀野
ほりぬ	掘り抜
ほりだ	掘り出
ほりた	堀田
ほりし	彫師
ほりさ	掘り下
ほりお	堀尾	掘り起
ほりえ	堀江
ほりい	堀井	堀居
ほりあ	掘り当
ほらど	洞戸
ほよう	保養	歩容
ほゆう	保有
ほやの	保屋野
ほめあ	誉め上
ほむら	焔	炎
ほむぎ	穂麦
ほまれ	誉れ	誉
ほまえ	帆前
ほほば	頬張
ほほえ	頬笑	微笑
ほべつ	穂別
ほへい	歩兵
ほぶね	帆船
ほふく	匍匐
ほひつ	補筆	輔弼	補弼
ほばら	保原
ほばく	捕縛
ほはば	歩幅
ほのみ	仄見
ほのじ	ほの字
ほのか	仄か
ほのお	焔	炎
ほねみ	骨身
ほねぬ	骨抜
ほねな	骨無
ほねつ	骨接
ほねぐ	骨組
ほねお	骨折
ほぬの	帆布
ほにん	補任
ほなみ	保奈美	穂波
ほなが	穂長	保永
ほなか	火中
ほない	保内
ほどよ	程良
ほどの	程野
ほどこ	施
ほどう	歩道	舖道	舗道	補導
ほとん	殆
ほとり	邊	滸	辺	邉	畔
ほとけ	仏	佛
ほとぎ	缶
ほてん	保典	補填
ほてつ	補綴
ほてい	布袋	保定	補綴	補訂
ほづみ	穂積
ほづな	帆綱
ほづつ	火筒
ほつれ	解れ
ほつご	発語
ほつぎ	発議
ほつい	発意
ほった	掘田	堀田
ほっす	払子	法子	法主
ほっさ	発作
ほっけ	法華
ほっく	発句
ほっき	発起
ほだか	穂高
ほだい	補題
ほたる	蛍	火垂る	螢
ほたに	保谷
ほたて	帆立
ほたか	穂高
ほたい	補体	保体
ほぞん	保存
ほぞく	保続
ほそや	細矢	細谷
ほそめ	細目	細め
ほそみ	細身	細見	細み
ほそべ	細部
ほその	細野
ほそつ	歩卒
ほそだ	細田
ほそじ	細字
ほそく	補足	歩測	補則	歩速	捕捉
ほそぎ	細切	細木
ほそき	細木
ほそえ	細江
ほそう	鋪装	舗装
ほそい	細井
ほぜん	保全
ほぜい	保税
ほせん	保線	補選
ほせつ	補説
ほせき	舗石
ほせい	補正	補整
ほずみ	穂積
ほすう	補数	歩数
ほすい	保水
ほじょ	補助
ほじそ	穂紫蘇
ほじく	穿
ほしん	保身
ほしゅ	保守	捕手	補手
ほしや	星矢	星谷
ほしみ	星見
ほしふ	星降
ほしば	保志場	干場
ほしの	星野
ほしな	星名	保科
ほしで	星出
ほしつ	保湿
ほしい	欲しい	糒	星井
ほざわ	保沢
ほさつ	補殺	捕殺
ほさく	補作
ほさき	芒	穂先
ほさか	保坂
ほごし	保護司
ほごく	保護区
ほころ	綻
ほこり	埃	誇り
ほこら	祠	叢祠
ほこた	鉾田
ほこう	補講	歩行
ほげん	補元
ほげた	帆桁
ほげい	捕鯨
ほけん	保健	保険
ほけつ	補欠
ほぐみ	穂組み
ほくろ	黒子
ほくぶ	北部
ほくと	北都	北斗
ほくち	火口
ほくそ	樮
ほくし	北史
ほくが	北画
ほくい	北緯
ほきん	保菌
ほがた	保型
ほがい	補外
ほかん	補完	保管	補間
ほかの	他の
ほかに	他に
ほかぜ	帆風
ほかげ	帆影	火影	灯かげ
ほかく	補角	保革	捕獲
ほおん	保温
ほおば	頬張	朴歯
ほえた	吠え立
ほえき	補益
ほうわ	法話	豊和	飽和
ほうり	法理	宝利
ほうら	和了
ほうや	保谷
ほうむ	放夢	法務	葬
ほうぶ	邦舞
ほうふ	豊富	防府	飽負	豊府	豊冨	抱負
ほうび	褒美
ほうひ	豊肥	放屁	包皮
ほうば	放馬
ほうど	封土	邦土
ほうと	方途
ほうっ	放
ほうち	報知	放置	法治	封地
ほうだ	法田
ほうそ	硼素	B	Boron
ほうじ	法事	捧持	邦字
ほうし	芳志	包子	褒詞	胞子	奉仕	法師	放恣	奉伺	奉祀
ほうざ	砲座
ほうご	法語	邦語
ほうこ	宝庫
ほうげ	放下
ほうぐ	反故	法具
ほうき	放棄	菷	宝器	彗	抛棄	芳紀	伯耆	法規	法器	箒	帚	蜂起
ほうが	萠芽	芳賀	奉加	邦画	奉賀	萌芽
ほうか	邦貨	烽火	放火	法科	法貨	放下	邦家	法家	砲火	放課
ほうえ	法衣	法会
ほうい	法衣	包囲	方位
ほいろ	焙炉
ほいつ	捕逸
ほいだ	穂井田
ほいく	哺育	保育
ほあん	保安
ほあし	帆足
へんろ	遍路	変ロ
へんむ	片務
へんみ	逸見	辺見
へんほ	変ホ
へんへ	変ヘ
へんぷ	返付
へんぴ	辺鄙
へんぱ	偏波	偏頗
へんは	変ハ
へんに	変ニ
へんど	辺土
へんと	変ト
へんち	辺地
へんそ	辺素
へんじ	返辞	片時	変事	返事
へんし	返詩	変死
へんさ	騙詐	偏差
へんこ	偏固
へんげ	変化
へんき	偏倚	偏奇
へんか	変化	返歌
へんい	偏移	変位	偏位	変イ	変移	変異
へらい	戸来
へやぎ	部屋着
へめぐ	歴回	経回
へびざ	蛇座
へのじ	への字
へのこ	陰核
へつら	諛	諂
へちま	糸瓜
へだて	隔て
へしお	圧し折
へさき	舳	舳先
へぐり	平群
へくと	hecto
へきち	僻地
へきが	壁画
へいわ	平和
へいろ	閉路	平炉
へいり	弊履	敝履
へいゆ	平癒
へいや	平野
へいぶ	弊部
へいふ	敝賦
へいび	兵備
へいば	兵馬
へいち	平地	併置	並置
へいそ	平素
へいじ	平治	平次	兵事	平時
へいし	閉止	弊紙	瓶子	平氏	斃死	兵士	弊誌
へいさ	閉鎖
へいご	平語
へいけ	平家
へいき	兵器	併記	並記	平気
へいが	平臥
へいか	兵火	閉果	兵科	平価	陛下	閉架	併科
へいい	平易	弊衣
ふんむ	噴霧
ふんぼ	墳墓
ふんば	踏ん張
ふんぬ	憤怒	忿怒
ふんど	憤怒	糞土	忿怒
ふんづ	踏ん付	糞詰
ふんぞ	踏ん反
ふんし	憤死
ふんご	分後
ふんぎ	紛議
ふんき	奮起	噴気
ふんか	噴火
ふんい	雰囲
ふわり	譜割
ふわた	不渡
ふわけ	腑分け
ふわく	不惑
ふろや	風呂屋
ふろば	風呂場
ふろく	附録	付録
ふろう	浮浪	不老	不労
ふろあ	風呂上
ふれる	振れる
ふれこ	触れ込
ふれい	布令	譜例	不例	負例
ふれあ	触れ合	触合
ふるや	古谷	古家	古矢	古屋
ふるま	振る舞	振舞
ふるぼ	古惚
ふるび	古び
ふるの	古野
ふると	古戸
ふるて	古手
ふるた	古田
ふるせ	古瀬
ふるす	古過	古巣
ふるぎ	古着
ふるき	古木
ふるえ	古恵	古江	震え
ふるう	古宇
ふるい	古い	古井	篩
ふりん	不倫
ふりわ	振り分
ふりょ	俘虜	不慮	俘慮
ふりや	降り止
ふりむ	振り向
ふりま	振り撒
ふりに	振り逃
ふりつ	降り積	府立	振付	振津	振り付
ふりだ	振り出	降り出
ふりた	振り足
ふりさ	振り放
ふりこ	振り込	振り子	降り込	振子	振込
ふりき	振り切
ふりか	振り掛	振り替
ふりお	振り落
ふりあ	振り上
ふらん	孵卵	腐爛	不乱	腐乱
ふらの	富良野
ふらち	不埒	不埓
ふよく	扶翼
ふよう	浮葉	浮揚	不要	芙容	芙蓉	扶養	不溶	不用
ふゆみ	冬美
ふゆび	冬日
ふゆば	冬晴	冬場
ふゆの	冬野
ふゆな	冬菜
ふゆこ	冬子
ふゆげ	冬毛
ふゆぎ	冬着
ふゆき	冬木	冬樹
ふゆが	冬枯
ふゆう	富有	富裕	浮遊	浮有
ふもん	不問
ふもと	麓	梺
ふもう	不毛
ふめん	譜面	符面
ふめつ	不滅
ふめい	不明
ふむき	不向き
ふみん	富民	府民	不眠
ふみわ	踏み分
ふみよ	文代	扶三代
ふみや	郁也	文也
ふみば	踏み場
ふみな	踏み鳴
ふみと	史人	文人
ふみつ	踏み付
ふみち	踏み散
ふみだ	踏み出
ふみし	踏み締	二三四
ふみこ	ふみ子	史子	冨美子	踏み越	文子	踏み込	踏込	富美子
ふみき	踏み切
ふみか	史佳
ふみお	二三男	文夫	文男	文雄	文郎	史男	郁雄	史夫	史緒
ふみえ	踏絵	踏み絵	文絵
ふみい	踏み入
ふまん	不満
ふまえ	踏まえ
ふまい	不昧
ふぼん	不犯
ふぼく	浮木
ふほじ	不保持
ふほう	不法	訃報
ふべん	不便
ふへん	不変	普遍	不偏	不遍
ふへき	扶壁
ふへい	不平
ふぶん	腑分	不文
ふぶき	吹雪	風吹
ふふく	不服
ふびん	不憫	不便	不敏
ふばん	符番
ふばら	不払
ふばつ	不抜
ふばい	不買
ふはつ	不発
ふはく	布帛	浮薄
ふはい	腐敗	不敗
ふのり	布海苔
ふのう	不能	富農	不納
ふねん	不稔	不燃
ふねや	船屋
ふぬけ	腑抜け
ふにん	不妊	赴任
ふにく	腐肉
ふなわ	舟和
ふなれ	不慣れ	不馴れ
ふなり	不成
ふなよ	船酔
ふなゆ	船湯	淦
ふなも	舟盛
ふなま	船間
ふなほ	船穂
ふなば	船場
ふなの	船乗
ふなに	船荷
ふなど	船戸
ふなと	船渡	舟渡
ふなで	船出
ふなづ	船積
ふなつ	船津	舟津
ふなだ	船田
ふなじ	船路
ふなこ	舟子
ふなぐ	船具
ふなき	舟木	船木
ふなか	不仲
ふない	船井	府内
ふどき	風土記
ふどう	不同	府道	不動	浮動
ふとん	布団	蒲団
ふとめ	太目	太め
ふとど	不届
ふとじ	太字
ふとし	太司	太
ふとく	婦徳	不徳
ふとう	不当	不凍	埠頭	不等	不党	不倒	不撓
ふでた	筆立
ふでき	不出来
ふでが	筆画
ふでお	筆下
ふでい	筆入
ふてん	符点	普天
ふてね	ふて寝	不貞寝
ふてき	不適	不敵
ふてい	不弟	婦弟	不貞	不定	不悌	不逞
ふづき	文月
ふつわ	仏和
ふつご	仏語
ふつか	二日	2日	２日
ふつう	普通	不通	ふつ〜
ふっと	吹っ飛
ふっつ	富津
ふっそ	F	Flourine
ふっさ	福生
ふっこ	復古
ふっき	吹っ切	復帰
ふっか	吹っ掛	フッ化
ふちん	浮沈	不沈
ふちの	渕野
ふちど	縁取
ふちじ	府知事
ふだん	普段	不断
ふだば	札場
ふだい	譜代	府大	普代
ふたん	負担
ふたわ	二和
ふたり	２人	二人	2人
ふため	二目	不為
ふたみ	双三	双海	二美	二見
ふたま	二間
ふたば	雙葉	双葉	二葉
ふたて	二手
ふたつ	布達	弍	２つ	2つ	二つ	双	二	不達
ふたた	再
ふたせ	二瀬
ふたし	不確
ふたご	双子
ふたこ	二子
ふたく	負託	付託
ふたえ	二重
ふたい	付帯	附帯
ふぞろ	不揃
ふぞく	附属	付属
ふそん	不遜
ふそく	付則	附則	不足	不測
ふそう	扶桑
ふぜん	不善	不全
ふぜい	風情
ふせん	付箋	不戦	不宣	普選	附箋
ふせや	伏屋
ふせつ	布設	符節	負節	浮説	敷設	付設
ふせじ	ふせ字	伏字	○○○	×××	△△△	伏せ字	□□□
ふせぎ	伏木
ふせき	布石
ふせい	不斉	父性	負性	不整	夫姓	府政	不正
ふずい	付随	附随	不随
ふすま	衾	襖
ふすう	負数
ふじん	夫人	婦人	布陣	不尽
ふじょ	婦女	扶助	巫女
ふじや	藤屋	不二屋	富士屋	不二家
ふじみ	富士見	富士美	不死身
ふじま	藤間
ふじの	藤野
ふじと	藤戸
ふじつ	不実	藤津	不日
ふじた	冨士田	藤田
ふじせ	藤瀬
ふじし	富士市
ふじこ	富士子	不二子	藤子	冨士子
ふじき	藤城	藤木
ふじか	藤花
ふじお	冨士雄	富士夫	不二夫	藤尾	富士雄	不二雄	藤雄
ふじえ	藤江
ふじう	藤生
ふじい	藤井
ふしん	不信	不審	不振	普請	腐心
ふしゅ	浮腫
ふしゃ	富者
ふしめ	伏し目	節目
ふしみ	伏見
ふしど	臥所
ふしづ	節付
ふしつ	不悉
ふしじ	不支持
ふしぎ	不思議
ふしき	伏木
ふざん	釜山	巫山
ふざけ	巫山戯
ふざい	不在
ふさん	不参	不讃
ふさわ	相応
ふさこ	扶佐子	房子	夫査子
ふさぐ	閼
ふさく	不作
ふさい	夫妻	負載	負債	付載	不才	不採
ふごう	符合	負号	附合	富豪	符号
ふこつ	腐骨
ふこく	布告	富国
ふこう	不孝	附高	不幸	不興
ふげん	誣言	普賢	付言	富源	不言
ふげき	巫覡
ふけん	夫権	父権	府県
ふけゆ	更け行
ふけつ	不潔
ふけだ	深田
ふけこ	老け込
ふけい	府警	婦警	不敬	父系	父兄
ふぐり	睾丸
ふぐか	不具化
ふぐう	不遇
ふくん	夫君	父君
ふくろ	嚢	袋	復路	副露
ふくり	福利	複利
ふくや	福家	福屋	服屋
ふくも	服喪
ふくむ	服務
ふくみ	含み
ふくま	福間
ふくべ	福部
ふくぶ	腹部
ふくひ	複比
ふくの	福野
ふくど	覆土
ふくで	福田
ふくつ	不屈
ふくち	福地
ふくだ	福田
ふくそ	複素
ふくじ	福地	服地	福治	副次
ふくし	福祉	復氏	福司	複視	副詞	福士	副使
ふくざ	複座
ふくさ	帛紗	袱紗	副査
ふくぎ	福木	副木
ふくが	腹臥	伏臥
ふくか	複果
ふくえ	福江	福栄
ふくう	不空
ふくい	福居	復位	福井
ふぎり	不義理
ふきん	付近	布巾	賦金	附近
ふきよ	吹き寄
ふきや	蕗谷	吹屋	吹き矢	吹き止	吹矢
ふきの	吹野
ふきぬ	吹き抜	吹抜
ふきな	吹き鳴
ふきと	吹き飛	拭き取
ふきで	噴き出	吹き出
ふきつ	不吉	吹き付
ふきち	吹き散
ふきだ	吹き溜	噴き出	吹き出
ふきそ	不起訴
ふきさ	吹き冷
ふきこ	吹き込
ふきけ	吹き消	拭き消
ふきか	吹き替	吹替	吹き掛	葺き替
ふきお	吹き下
ふきあ	吹き荒	吹き上
ふがね	府金
ふがく	富嶽	不学
ふがい	府外
ふかん	俯瞰	不完	不感
ふかわ	府川	布川
ふかよ	深読
ふかや	深谷
ふかみ	深海	深見	深み
ふかひ	不可避	深緋
ふかの	深野
ふかで	深手
ふかつ	深津	賦活
ふかち	不可知
ふかだ	深田
ふかた	深田
ふかせ	深瀬
ふかす	深過
ふかし	不可視
ふかさ	負荷差	深さ
ふかく	不覚	俯角
ふかお	深尾	深追
ふかえ	深江
ふかい	深い	腐海	深井	附会	府会	付会	不快	深入	渓井	不会
ふおん	不穏
ふおう	不応
ふえん	敷延	不縁	布衍	敷衍
ふえふ	笛吹
ふえて	不得手
ふえき	不易	賦役
ふえい	府営
ふうん	不運	浮雲
ふうゆ	諷諭
ふうむ	風夢
ふうみ	風味
ふうま	風魔
ふうふ	夫婦
ふうび	風靡
ふうひ	封皮
ふうは	風波
ふうど	風土
ふうち	風致
ふうじ	封じ
ふうし	夫子	封止	諷刺	風刺	風姿
ふうさ	封鎖
ふうぎ	封切	風儀
ふうき	富貴	風紀
ふうが	風雅
ふうか	風化
ふうう	風雨
ふうい	風位
ふいん	訃音
ふいり	不入り
ふいつ	不一
ふいご	鞴	吹子
ふいく	扶育
ふあん	不安
ふあつ	負圧
ふぁん	翻	飜
ふぁい	φ
ひんむ	引ん剥
ひんぷ	貧富	稟賦
ひんば	牝馬
ひんど	貧土	頻度
ひんだ	貧打
ひんじ	賓辞
ひんし	品詞	瀕死
ひんく	貧苦
ひんぎ	稟議
ひんか	貧家
ひんい	品位
ひわれ	干割れ
ひわり	日割り	日割
ひわだ	檜皮
ひわた	火渡
ひわさ	日和佐
ひわき	樋脇
ひわい	卑猥	鄙猥	卑わい
ひろや	浩也	博也
ひろめ	広め	披露目
ひろみ	比呂美	拡稔	博美	弘巳	広美	浩巳	浩美	裕実	洋美	寛美	宏美	博己	ひろ美	弘美	広見	裕美	弘海	引美
ひろま	広間
ひろべ	広部
ひろば	広場
ひろの	広野
ひろと	浩登	寛人	裕人	博人
ひろづ	広津
ひろつ	広津
ひろた	広田	弘田	廣田
ひろせ	広瀬	廣瀬
ひろす	広過
ひろじ	広治	宏治
ひろし	裕	博司	愽	広司	啓之	浩司	大史	宏史	博	裕司	ひろ志	弘志	浩士	大志	大士	弘司	熈	裕志	洋史	博嗣	啓志	比呂志	寛	博士	弘史	宏司	裕史	廣志	弘	広史	大	博志	宏	熙	泰	廣	洋	浩	洋司	煕	浩志	広志	広	央	宏志	博史	浩史
ひろこ	宏子	宙子	寛子	広子	浩子	紘子	弘子	裕子	ひろ子	倫子	博子	欧子
ひろぐ	弘具
ひろく	広く	秘録
ひろき	弘樹	裕樹	浩喜	博紀	寛己	裕貴	浩貴	広樹	洋樹	浩基	博基	寛紀	弘城	博樹	裕毅	博己	啓樹	宏樹	弘毅	裕紀	宏喜	央樹
ひろか	祥加	裕香
ひろお	洋夫	宏雄	博雄	浩生	洋男	広尾	博生
ひろえ	弘枝	宏枝	広江	浩恵	広恵	広絵	廣江	宏江	裕江	浩江
ひろう	披露	疲労	疲勞
ひろい	広井
ひれん	悲恋
ひれふ	平伏
ひれつ	卑劣
ひれき	披瀝
ひれい	∝	非礼	比例
ひるま	晝間	昼間
ひるね	昼寝
ひるた	蛭田
ひるす	昼過
ひるさ	昼下
ひるこ	蛭子
ひるげ	昼餉
ひるい	比類
ひりん	比倫	比隣
ひりつ	比率
ひりき	非力
ひらら	平良
ひらゆ	平湯
ひらや	平屋	平谷
ひらめ	鮃	閃	平目
ひらま	平間
ひらば	平場
ひらの	平野
ひらね	平根
ひらど	平戸
ひらと	平戸	平綴
ひらで	平出
ひらて	平手
ひらづ	平積
ひらち	平地
ひらた	枚田	平田
ひらせ	平瀬
ひらじ	平地
ひらこ	平子
ひらく	啓
ひらき	開	平木
ひらが	平賀
ひらか	平鹿	平賀
ひらお	平尾	平生
ひらい	飛来	平井	避雷
ひよわ	ひ弱
ひより	日和
ひよし	日義	日吉
ひよこ	雛
ひよけ	火除け	日除け
ひよく	比翼	肥沃
ひよう	飛揚	日傭	比容	費用
ひょう	豹	標	馮	殍	飆	縹	平	氷	驫	飄	票	憑	彪	髟	兵	瓢	慓	表	評	拍	嫖	冫	漂	凭	驃	飃	俵	雹	剽	冰
ひゆか	譬喩歌
ひやま	日山	桧山	檜山	樋山
ひやけ	日焼け	日焼
ひやく	飛躍	秘薬	非役
ひやか	素見
ひゃく	襞	岶	百	辟	珀
ひもの	干物	檜物
ひもと	火元	紐解	繙
ひもち	日持ち
ひもじ	火文字	緋文字
ひもく	費目	皮目
ひもう	被毛
ひめん	罷免
ひめの	姫野
ひめど	姫戸
ひめじ	姫路
ひめこ	姫子
ひめき	姫木
ひめい	碑銘	悲鳴	非命
ひむろ	氷室
ひむら	日村
ひみん	卑民
ひみつ	秘密
ひみこ	卑弥呼	日美子
ひまん	肥満
ひまつ	飛沫
ひまち	日待ち
ひまし	日増し
ひまご	曾孫
ひまく	被膜	皮膜
ひぼん	非凡
ひぼし	干乾し	日干
ひぼう	誹謗	非望
ひほん	秘本
ひほじ	非保持
ひほう	非法	悲報	飛報	秘法	秘宝
ひへん	炸	火偏	日偏
ひへい	疲弊
ひぶん	非分	非文	碑文
ひぶつ	秘仏
ひぶた	火蓋
ひふん	悲憤
ひふみ	一二三	日文
ひふち	非負値
ひふく	被覆	被服
ひふか	皮膚科
ひびわ	罅割
ひびや	日比谷
ひびの	日比野
ひびき	響	響き
ひばん	非番
ひばり	雲雀
ひばら	檜原	脾腹	桧原
ひばな	火花
ひばち	火鉢
ひばし	火箸
ひばく	飛瀑	被縛	被曝	被爆
ひばい	非売	肥培
ひはん	批判
ひはら	日原
ひはつ	被髪
ひはく	皮帛	菲薄
ひはい	疲憊
ひのめ	日の目
ひのべ	日延べ
ひのと	丁
ひので	日出	日の出	日之出
ひのて	火の手
ひのし	日野市
ひのこ	火の粉
ひのけ	火の気
ひのき	桧	檜
ひのえ	丙
ひのい	日の入
ひねん	比年
ひねり	捻り
ひねの	日根野
ひねつ	比熱
ひにん	非人	避妊	否認
ひにち	日々	日日	日にち
ひにく	髀肉	皮肉
ひなん	批難	非難	避難
ひなわ	火縄
ひなつ	日夏
ひなた	日向
ひなせ	日生
ひなこ	比奈子	日名子	日向子	雛子
ひなか	日中
ひない	比内
ひどり	日取り
ひどこ	火床
ひどう	非道
ひとり	独り	一人	独	獨り	1人	１人
ひとよ	一世	人寄	一夜
ひとや	人屋
ひとめ	ひと眼	人目	一目
ひとみ	仁美	一美	瞳	人見
ひとま	一間	人待
ひとひ	一日
ひとは	一葉
ひとな	人並
ひとで	海星	人手	人出
ひとて	一手
ひとつ	1つ	非凸	１つ	一つ
ひとた	一溜
ひとず	人好
ひとし	準	倫	人知	仁司	仁志	人志	仁	均	等し	倫史	等	斉	仁史	斎
ひとご	人込	人混
ひとけ	人気
ひとく	秘匿	人喰
ひとぎ	人聞
ひとき	一切
ひとか	人買
ひとえ	一重	偏	単	單
ひとう	秘湯
ひとあ	一荒	一当
ひでん	飛電	秘伝
ひでり	旱	魃	日照り
ひでよ	英世	秀世
ひでや	秀也	英也	日出谷	英哉	秀哉
ひでみ	英実	秀実	英美	英巳	秀美
ひでと	秀仁	英人	秀人	日出登
ひでじ	秀司	英司
ひでし	日出志
ひでこ	英子	秀子
ひでき	偉紀	秀記	英樹	秀紀	秀規	秀起	秀貴	英紀	秀樹	秀己
ひでか	秀香	秀加
ひでお	秀郎	英朗	英男	秀生	秀男	英夫	周男	秀夫	英生	日出夫	映夫	秀雄	英雄	日出男
ひてん	批点	飛天
ひてつ	非鉄
ひてい	飛程	否定	¬
ひづめ	蹄
ひづけ	日付	日付け
ひつび	必備
ひつば	弼馬
ひつじ	羊	日辻	未
ひつけ	火付け
ひつぎ	柩	棺
ひつき	火付き
ひつう	悲痛
ひつい	筆意
ひっぷ	匹夫	匹婦
ひっぱ	引張	引っ張
ひっつ	引っ付
ひっち	筆致
ひった	引っ立
ひっす	必須
ひっし	必死	筆紙	必至
ひっこ	引込	引っ込	引越	引っ越
ひっき	筆記
ひっか	引っ掻	筆禍	引っ掛
ひだん	被弾
ひだる	饑
ひだり	（	【	＜	『	「	左	←
ひだら	干鱈
ひだま	日溜	火玉
ひだね	火種
ひだち	肥立ち
ひだか	肥高	日高
ひだい	比田井	肥大
ひたん	悲嘆	悲歎
ひたち	日立	常陸	肥立
ひたき	鶲
ひたい	額
ひぞく	卑俗	匪賊	卑属
ひぞう	秘蔵	脾臓
ひそみ	顰み
ひそく	秘色
ひそか	密	密か
ひそう	悲壮	悲想	悲愴	皮相	皮層
ひぜん	肥前
ひぜろ	非ゼロ	非零
ひぜめ	火攻め	火責め
ひぜに	日銭
ひせん	卑賤	非戦	飛箭
ひせつ	飛雪	秘説
ひせき	秘蹟	砒石	碑石	飛跡
ひせい	悲悽	批正
ひずみ	歪
ひずけ	日付	日付け
ひすい	翡翠
ひじり	聖
ひじょ	秘女
ひじこ	非自己
ひじき	鹿尾菜
ひじか	肘掛
ひしん	皮疹
ひしょ	避暑	秘所	秘書
ひしゅ	脾腫	匕首	秘酒
ひしゃ	扉車	拉	飛車
ひしめ	犇
ひしね	菱根
ひしと	緊と	犇と
ひしつ	皮質
ひしだ	菱田
ひした	菱田
ひしお	醢	醤
ひざら	火皿
ひざし	日差	陽射	日射し	日差し	日ざし	陽射し
ひざか	膝掛
ひさん	悲惨	砒酸	飛散	非惨
ひさよ	久代
ひさや	久屋	久弥
ひさめ	氷雨
ひさま	久馬
ひさば	久馬
ひさの	久野
ひさと	久人	尚登	久登	尚人
ひさだ	久田
ひさし	壽	久司	寿史	尚	寿	恒	久志	庇	尚志	廂	久	央
ひさご	匏	瓠	蠡	瓢
ひさこ	比佐子	寿子	久子	妃沙子
ひさく	秘策
ひさき	久木	寿樹
ひさか	樋坂	日阪	桶坂
ひさお	久雄	寿夫	寿男	久夫	尚夫	久男	尚生	寿雄	尚勇
ひさえ	久恵	寿恵	寿江	久栄
ひさい	被災	久居
ひごろ	日頃
ひごと	日毎
ひごか	庇護下
ひごう	非業	非合
ひごい	緋鯉
ひこの	彦野
ひこね	彦根
ひこつ	腓骨
ひこく	被告
ひこえ	彦衛
ひこう	披講	飛講	非行	肥厚	飛行	秘孔	飛光
ひげね	鬚根	ひげ根
ひげき	悲劇
ひげい	秘芸
ひけん	比肩	披見	被験
ひけめ	引け目
ひけね	引け値
ひけつ	否決	秘結	秘訣
ひけた	引田
ひけし	火消し
ひけい	秘計
ひぐれ	日暮れ	日暮
ひぐま	日熊	羆
ひぐち	火口	樋	樋口
ひくめ	低目
ひくみ	低み
ひくま	曳馬
ひくて	引く手
ひくつ	卑屈
ひくす	低過
ひくう	非空
ひきん	卑近
ひきわ	引き分	碾き割	挽き割
ひきよ	引き寄
ひきや	引家	曳家
ひきめ	蟇目
ひきみ	匹見
ひきは	引き剥
ひきの	引き延	引き伸
ひきぬ	引き抜
ひきに	轢き逃
ひきど	引戸
ひきと	引き止	引き取	引取
ひきて	引手	弾き手	引き手
ひきつ	引き継	引き攣	引き連	引継	引き付
ひきち	引地
ひきだ	弾き出	疋田	引出	引き出	引田
ひきた	疋田	引き立	引立	引田
ひきず	引き摺
ひきし	引締	引き締
ひきさ	引き去	引下	引き裂	引き下
ひきこ	引き込
ひきか	引き替	引き換
ひきお	引き起	引尾	惹き起	引き下
ひきう	引受	引き受
ひきい	引き入	率い
ひきあ	引き合	引き上	引き揚	引当	引き当	引合
ひがん	悲願	彼岸
ひがら	日柄	日雀
ひがめ	僻目
ひがね	日金
ひがた	干潟
ひがし	干菓子	東
ひがさ	日傘
ひがけ	日掛け
ひがき	桧垣	檜垣
ひがえ	日帰
ひがい	被害	鰉
ひかん	卑官	避寒	悲観
ひかわ	氷川	斐川	簸川
ひかる	光	熈
ひかり	芒	光
ひから	乾涸	干涸
ひかみ	氷上
ひかた	日方	干潟
ひかず	日数
ひかげ	日陰	日蔭	火影	日影
ひかく	皮革	皮角	飛角	比較	非核
ひかき	火掻き
ひかえ	控	控え
ひおけ	火桶
ひおき	日置
ひおう	秘奥
ひえん	飛燕
ひえづ	日吉津
ひえだ	稗田	檜枝
ひえこ	冷え込
ひえき	冷え切	裨益	桧枝岐
ひえい	飛影	飛栄	比叡
ひうん	飛雲	悲運	非運
ひうら	日裏	火浦	樋浦	日浦
ひうち	火打ち	燧
ひうお	氷魚	干魚	乾魚
ひいろ	緋色
ひいれ	火入れ
ひいな	雛
ひいく	肥育
ひいき	贔屓
ひあみ	火網
ひあそ	火遊
ひあい	悲哀
はんわ	阪和
はんろ	坂路	販路
はんら	半裸
はんや	半夜
はんも	繁茂
はんむ	煩務	繁務
はんみ	半身
はんま	半間
はんぽ	半歩
はんぷ	帆布	頒布
はんぱ	半端	半波
はんば	半場	飯場
はんね	半値
はんな	阪奈
はんと	版図	叛徒	半途
はんて	半手
はんち	半値
はんだ	盤陀	半田
はんた	煩多	繁多
はんそ	反ソ	反訴
はんじ	半時	判じ	判事	判示
はんし	半紙	藩士	範士	半死
はんさ	煩瑣
はんご	反語
はんこ	判子
はんぐ	版組
はんく	半句
はんぎ	半技	版木
はんき	半季	半期	叛旗	搬器	半旗
はんが	版画
はんか	半価	半跏	汎化	繁華	反歌	頒価
はんい	叛意	犯意	範囲
はわた	刃渡
はわい	布哇	羽合
はろう	波浪
はれま	晴間	晴れ間
はれば	晴れ晴
はれつ	破裂
はれぎ	晴れ着	晴着
はれお	晴夫
はれあ	腫れ上
はるよ	春代
はるみ	晴海	はる美	晴美	晴見	春美
はるび	腹帯
はるひ	晴日	春日
はるの	春野	榛野
はるな	榛名	春菜
はるだ	春田
はるた	春田
はるじ	春治
はるし	治志
はるこ	治子	春子	晴子
はるぎ	春着
はるき	春木	治己	春樹
はるか	美佳	遥か	遥	悠	春歌	遙	晴香
はるお	治雄	晴朗	晴雄	治夫	東生	治男	春雄	春男	晴夫	春夫
はるえ	治恵	春江
はりん	破倫
はりよ	針魚
はりや	針谷
はりめ	針目
はりま	播摩	針間	播磨
はりて	張手	張り手
はりつ	張り詰	張り付	破笠	貼り付
はりだ	張り出
はりす	鉤素
はりし	鍼師
はりさ	張り裂	針刺
はりこ	針子	貼り込	はり込	張り込	張子
はりき	張り切	針木
はりか	張り替	貼り替
はりあ	貼り合	張り合	張合	張り上
はらん	波蘭	波乱	波瀾
はらへ	腹減
はらば	腹這
はらの	原野
はらだ	原田	腹立
はらた	腹立
はらこ	原子
はらき	原木	腹切
はらか	腹赤
はらお	原尾
はらい	拂	祓	払	祓い	赦い	払い
はやり	流行	流行り
はやめ	速目	早め	早目
はやみ	速見	早見	速水
はやま	葉山	端山	羽山	早馬
はやば	早場
はやの	早野
はやね	早寝
はやと	勇人	隼人	早戸
はやで	早出
はやて	疾風
はやだ	早出
はやた	早田
はやせ	早瀬	早勢
はやす	早過	速過
はやし	囃子	林	囃
はやざ	早咲
はやさ	速さ
はやぐ	早食
はやく	早く	破約	端役
はやき	隼輝	勇樹
はやお	早起	駿	早生
はやう	早打
はやい	速い
はもん	破門	刃文	波紋
はもの	葉物	端物	刃物	釖
はめん	波面
はめつ	破滅
はめこ	嵌め込
はむろ	葉室
はむら	羽村	葉叢
はむし	羽虫
はみで	はみ出
はみだ	はみ出
はみが	歯磨
はまや	浜屋	破魔矢
はまべ	浜辺	浜部
はまの	濱野	浜野
はまな	浜名
はまで	濱出
はまち	刃区
はまだ	濱田	浜田
はまこ	浜子
はまき	葉巻
はまお	浜尾
はぼろ	羽幌
はぼう	破帽
はほん	端本
はほろ	羽幌
はへん	破片	歯偏
はへい	派兵
はぶり	羽振り
はふり	祝
はびこ	蔓延
はばよ	幅寄
はばつ	派閥
はばた	羽搏
はばき	幅木
はばか	憚
ははご	母御
ははこ	母子
はねの	撥ね除
はねだ	羽田
はねじ	羽地
はねぎ	葉葱	羽根木
はねあ	跳ね上
はぬけ	歯抜け
はにわ	埴輪
はなわ	花輪	鼻輪	花環	塙
はなら	歯並
はなや	花屋
はなも	鼻持
はなみ	歯並	花実	花見	羽並
はなび	花冷	花火
はなは	堪	甚
はなの	花野
はなづ	鼻詰
はなぢ	鼻血
はなだ	縹	花田
はなた	花田
はなせ	花背
はなじ	衂	衄	鼻血
はなし	咄	話	噺	譚	話し
はなさ	鼻差	花咲
はなこ	花子	華子
はなげ	鼻毛
はなぎ	鼻木
はなき	花木	花紀
はなが	花香
はなお	鼻緒
はなえ	英恵	花江
はなう	花売
はない	花井
はどり	羽鳥
はどめ	歯止め	歯止
はどう	覇道	波導	波動
はとり	羽鳥
はとば	波止場
はとは	鳩派	ハト派
はとの	鳩野
はとざ	鳩座
はとこ	再従姉妹	再従兄弟
はとう	陂塘	波涛	波濤	坡塘	波頭	坡頭
はでめ	派手目
はてな	？
はてし	果てし
はづな	端綱
はづき	葉月
はつわ	発話
はつろ	発露
はつゆ	初湯
はつみ	初実	初見
はつほ	初穂
はつひ	初日
はつの	初乗
はつね	初音	初値
はつに	初荷
はつで	初出
はつだ	発兌
はつた	初田
はつご	初子	発語
はつぎ	発議
はつが	発芽
はつか	二十日	廿日	２０日	20日
はつお	初男
はつえ	初絵	初江
はつう	初売
はつい	発意
はっぷ	発布	髪膚
はっぴ	法被
はっぱ	発破	葉っぱ
はっと	法度
はった	八田
はっこ	発呼
はっけ	八卦
はっく	発句	八九	八苦
はっき	白旗	発輝	発揮	発起
はっか	客家	白化	薄荷	発火
はちろ	八路
はちや	鉢谷	八谷	蜂屋
はちぶ	八部	８分	八分
はちす	蓮	蜂巣
はちじ	八時
はちく	破竹
はちき	はち切
はちう	鉢植
はちあ	鉢合
はだん	破談	破断
はだみ	肌身
はだの	秦野
はだし	跣	裸足
はだぎ	肌着
はだか	肌掛	裸
はだあ	肌合
はたん	破綻
はたら	働
はたや	畑谷	機屋
はため	はた目	傍目
はたぶ	幡生
はたふ	旗振
はたび	旗日
はたば	機場
はたの	籏野	波多野	畑野	秦野	幡野	羽田野
はたて	旗手
はたち	畑地	二十	２０歳	二十歳
はただ	畠田	畑田
はたた	羽撃
はたさ	畑佐
はたご	旅籠
はたけ	畑	畠
はたえ	波多江	二十重
はたい	波帯
はたあ	旗揚
はそん	破損
はそく	波束	把捉
はせん	破線	破船	波線
はせみ	長谷見
はせべ	長谷部
はせい	派生	長谷井
はずれ	葉擦れ	外れ	外
はずか	恥ずか
はずえ	葉末
はずい	筈井
はすみ	羽純	蓮見	羽須美	蓮實	羽角
はすね	蓮根
はすだ	蓮田
はすこ	蓮子
はすか	Nelumbonaceae	ハス科
はすう	波数	端数	歯数
はすい	破水
はじろ	羽白
はじゃ	破邪	覇者
はじめ	元	創	一	哉	初め	弌	壱	馨	始	甫	初	壹	始め	肇
はじま	羽島
はじき	土師器
はじい	恥じ入
はしを	端折
はしり	走り
はしら	柱
はしょ	端折
はしゅ	把手	播種
はしゃ	覇者	燥
はしま	羽島
はしば	羽柴
はしの	橋野
はしだ	橋田
はした	端
はしぞ	箸初
はしご	梯子
はしけ	艀
はしか	麻疹
はしお	走尾	端折	箸置
はしい	端居
はざわ	羽沢	歯触
はざま	狭間	羽間	羽佐間	陌間	硲	間
はざい	端材
はさん	破産	破算
はさみ	螯	鋏	波佐見
はさま	挟間	迫
はさこ	羽迫
はさき	刃先	波崎
はさい	破摧	破砕
はごた	歯応
はごし	葉越し
はごく	破獄
はこん	破婚
はこや	箱屋
はこべ	繁縷
はこね	箱根
はこえ	箱絵
はこう	爬行	波高	破口	跛行
はこい	箱入
はげん	波源
はげま	励ま
はけん	派遣	覇権
はけい	波形
はぐろ	羽黒	歯黒
はぐく	毓	育
はぐき	歯ぐき	齦	歯茎
はくわ	白話
はくろ	白鷺	白露
はくり	剥離	薄利	白痢
はくや	白夜
はくめ	拍目
はくま	白魔
はくぼ	薄暮
はくふ	白布	伯父	帛布
はくび	白眉
はくば	白馬
はくち	泊地	白痴	白地
はくた	伯太
はくそ	歯屎
はくず	白図
はくじ	白字	白磁
はくし	薄志	博士	搏摯	白紙
はくさ	白砂
はくぎ	博儀
はくが	博雅
はくお	箔押
はくう	白雨
はくい	白衣	羽咋	伯井	伯夷
はくあ	白堊	白亜
はぎれ	端切れ	歯切	歯切れ
はぎり	歯切り
はぎや	萩谷
はぎの	萩野
はぎと	剥ぎ取
はぎた	萩田
はぎし	歯軋
はぎお	萩尾
はきち	吐き散
はきだ	はき出	吐き出	掃き出
はきす	吐き捨
はきけ	吐気	吐き気
はがん	破顔
はがわ	羽川
はがゆ	齒痒	歯痒
はがみ	歯噛み
はがね	鋼
はがた	歯形	歯型
はがき	葉書	葉書き
はがえ	羽替え
はかり	秤
はかま	袴
はかぶ	端株
はかば	墓場
はかな	果敢無	儚	果無
はかど	捗
はかた	伯方	博多
はかぜ	葉風	羽風
はかせ	博士
はかず	葉数
はかげ	葉影	葉陰
はかく	破格
はかい	破壊	破潰	破戒
はおり	羽織
はおと	羽音
はおく	破屋
はおう	覇王
はえぬ	生え抜
はえざ	蠅座
はうた	端唄
はいわ	俳話
はいろ	羽色	葉色	廃炉
はいる	配流
はいり	背離	背理
はいよ	這い寄
はいゆ	廃油
はいや	肺野	灰屋
はいめ	敗目
はいみ	俳味
はいぶ	背部
はいふ	配布	肺腑	配賦	配付
はいび	拝眉	配備
はいで	這い出
はいち	背馳	廃置	配置
はいだ	這い出	灰田
はいた	歯痛	排他
はいそ	敗訴
はいじ	拝辞
はいし	廃市	廃止	胚子	稗史	廃址
はいご	背後	廃語
はいぐ	拝具
はいく	俳句
はいき	排気	廃棄
はいが	拝賀	胚芽	俳画
はいか	配架	排架	配下	拝火	廃家
はいい	配位	配意	廃位
はいあ	這い上
はあん	破闇
はあく	把握
はーぐ	海牙
ほんろん	本論
ほんろう	翻弄
ほんれき	本暦
ほんるい	本塁
ほんらん	本欄
ほんらい	本来
ほんよみ	本読み
ほんゆう	本有
ほんやく	翻訳	飜訳
ほんもん	本問	本文
ほんもの	本物
ほんもと	本元
ほんもく	本牧
ほんもう	本望
ほんめい	奔命	本名	本命
ほんまる	本丸
ほんまつ	本末
ほんまち	本町
ほんぽう	奔放	本邦	本法	本俸	本報
ほんぺん	本編	本篇
ほんべつ	本別
ほんぷく	本復
ほんぶん	本文	本分
ほんぶり	本降り
ほんぴん	本品
ほんびき	本引
ほんぱん	紅幇
ほんばん	本番
ほんばば	本馬場
ほんばこ	本箱
ほんのう	本能
ほんねん	本年	本然
ほんぬり	本塗り
ほんぬい	本縫い
ほんにん	本人
ほんどく	本読
ほんどお	本通
ほんどう	本堂	本道
ほんとじ	本綴じ
ほんとう	本島	奔騰	本棟	本当
ほんでん	本殿	本伝	本田
ほんてん	本店
ほんてき	本的
ほんてい	本邸
ほんづけ	本付
ほんづか	本使
ほんつや	本通夜
ほんちば	本千葉
ほんだな	本棚
ほんだて	本立
ほんだち	本裁ち
ほんだい	本題	本代
ほんたて	本立	本立て
ほんたく	本宅
ほんたい	本態	本隊	本体
ほんぞん	本尊
ほんぞく	本属
ほんぞう	本草
ほんそく	本則
ほんそう	本葬	奔走	本送
ほんぜん	本然	翻然
ほんせん	本戦	本線	本選	本船
ほんせつ	本節
ほんせき	本籍
ほんせい	本性	本制	本姓
ほんずき	本好き
ほんすべ	本滑
ほんすじ	本筋
ほんすう	本数
ほんじん	本陣
ほんじょ	本所
ほんじつ	本日
ほんしん	本震	本心	本審
ほんしょ	本署	本所	本書	本初
ほんしゃ	本社
ほんしつ	本質
ほんしき	本式
ほんざん	本山
ほんさん	本三
ほんさく	本作
ほんさい	本妻
ほんごし	本腰
ほんごく	本石	本国
ほんごう	本郷	本号
ほんこん	香港
ほんこく	翻刻
ほんこう	本項	本稿	本校	本甲
ほんげん	本源
ほんげつ	本月
ほんげい	本芸
ほんけん	本権	本券	本件
ほんけつ	本決
ほんけい	本慧	本刑
ほんぐみ	本組
ほんぐう	本宮
ほんきん	本金
ほんきょ	本拠	本挙
ほんきじ	本記事
ほんがん	本願
ほんがわ	本川
ほんがく	本学
ほんかん	本館	本官	本艦	本管
ほんかわ	本革
ほんかく	本格
ほんかい	本懐	本会
ほんえい	本影	本営
ほんいん	本因	本院	本員
ほんいつ	奔逸
ほんいだ	本位田
ほんあん	翻案	本案
ほんあみ	本阿弥
ほんあざ	本字
ほろよい	微酔い
ほろべつ	幌別
ほろびゆ	滅び行
ほろびさ	滅び去
ほろのべ	幌延
ほろにが	ほろ苦
ほろつき	幌付き
ほろくさ	保呂草
ほれぼれ	惚れ惚れ
ほりわり	掘割
ほりゅう	保留	蒲柳
ほりもの	彫物
ほりもと	堀本
ほりまつ	堀松
ほりばた	堀端
ほりどめ	堀留
ほりだし	掘り出し
ほりすす	掘り進
ほりさき	堀崎
ほりごめ	堀米	堀込
ほりこし	堀越
ほりげん	堀玄
ほりぐち	堀口
ほりくず	掘り崩
ほりきり	堀切
ほりがね	堀金
ほりかわ	堀川	堀河
ほりかえ	掘り返
ほりうち	堀内
ほりいけ	堀池
ほらふき	ホラ吹き	ほら吹き	法螺吹き
ほらぐち	洞口
ほらがい	ほら貝	法螺貝
ほらあな	洞穴
ほようち	保養地
ほゆうき	保有機
ほやなぎ	保柳
ほめたた	誉め称
ほめそや	誉称	褒称
ほほづえ	頬杖
ほほずゑ	頬杖
ほほえみ	微笑	微笑み
ほばしら	帆柱	檣	艢
ほのぼの	仄仄	仄々
ほのじろ	仄白
ほのぐら	仄暗
ほねやす	骨休
ほねぼそ	骨細
ほねぶと	骨太
ほねぬき	骨抜	骨抜き
ほねなし	骨無し
ほねつぎ	骨接ぎ
ほねつき	骨付き
ほねぐみ	骨組み	骨組
ほねかわ	骨川	骨皮
ほねおり	骨折り
ほにゅう	哺乳
ほどほど	程々
ほどとお	程遠
ほどちか	程近
ほどこし	施し
ほどがや	保土が谷	保土ヶ谷
ほどあい	程合い	程合
ほとんど	殆んど	殆ど	幾ど	殆
ほとほと	幾	殆
ほとばし	迸
ほていか	補綴科
ほづがわ	保津川
ほつがん	発願
ほっぽう	北方
ほっとう	発頭
ほったん	発端
ほったて	掘っ立て	掘建	掘っ建て
ほっそく	発足
ほっせき	発赤
ほっしん	法身	発心	発疹
ほっこく	北国
ほっこう	北郊
ほっけど	法花堂
ほっかい	法界	北海
ほちょう	補聴	歩調
ほちゅう	捕虫	補注
ほたるび	蛍火
ほぞんじ	保存時
ほぞんこ	保存庫
ほそめん	細麺
ほそみち	細道
ほそまる	細丸
ほそまき	細巻
ほそぼそ	細々
ほそぶち	細渕
ほそびき	細引き
ほそはら	細原
ほそなが	細長
ほそせん	細線
ほそざわ	細澤
ほそざお	細棹
ほそごし	細腰
ほそぐち	細口
ほそくら	細倉
ほそがい	細貝
ほそかわ	細川
ほそおび	細帯
ほそおか	細岡
ほそうろ	舗装路
ほそうで	細腕
ほそいり	細入
ほせいち	補正値
ほじょろ	補助路
ほじょぼ	補助簿
ほじょぐ	補助具
ほじょう	圃場	捕縄
ほじゅう	補充
ほじしゃ	保持者
ほしよう	補仕様
ほしょく	補食	補職	補色	捕食
ほしょう	保証	保障	補償	堡礁	歩哨
ほしゅび	保守日
ほしゅひ	保守費
ほしゅは	保守派
ほしゅう	捕囚	補修	補習
ほしやま	星山
ほしゃく	保釈
ほしもと	星本
ほしみや	星宮
ほしぼし	星々
ほしにく	乾し肉	干し肉
ほしとり	星取り	星取
ほしたに	星谷
ほしぞら	星空
ほしじし	干肉
ほししば	星芝
ほしざわ	星沢
ほしさと	星里
ほしぐみ	星組
ほしくら	星倉
ほしくず	星屑
ほしくさ	乾し草	干し草	干草
ほしがた	星型
ほしがき	干柿	干し柿
ほしかわ	星川
ほしかげ	星影
ほしおき	星置
ほしいい	乾し飯	干し飯	糒
ほしあい	星合
ほさやく	補佐役
ほさにん	保佐人	補佐人
ほさたい	補佐隊
ほさかん	補佐官
ほさいん	補佐員
ほごわく	保護枠
ほごりん	保護林
ほごよう	保護用
ほごまく	保護膜
ほごしゃ	保護者
ほごさく	保護策
ほごこく	保護国
ほごえき	保護液
ほころび	綻び
ほこてん	歩行者天国
ほこすぎ	鉾杉
ほこさき	鋒先	鋒	矛先
ほこうそ	補酵素
ほこうき	歩行器
ほけんや	保険屋
ほけんふ	保健婦
ほけんし	保健師	保健士
ほけつば	補欠馬
ほくれい	北嶺
ほくりく	北陸
ほくよう	北洋
ほくめん	北面
ほくめい	北溟
ほくぼう	北房
ほくべい	北米
ほくへん	北辺
ほくへき	北壁
ほくふう	北風
ほくばく	北爆
ほくどう	北堂
ほくとき	北斗旗
ほくとう	北東
ほくでん	北電
ほくてん	北天
ほくてつ	北鉄
ほくてき	北狄
ほくだん	北淡
ほくだい	北大	北海道大学
ほくたん	北端
ほくそう	北叟
ほくせん	北線
ほくせつ	北摂
ほくせい	北星	北勢	北西
ほくしん	北辰	北進
ほくさい	北斎
ほくこう	北興
ほくげん	北限
ほくぐん	北軍
ほくがん	北岸
ほくおう	北欧
ほくえつ	北越
ほくえい	北瑛
ほぎうた	寿歌
ほきるい	補機類
ほきょう	補強
ほきゅう	補給	捕球
ほきもと	保木本
ほがらか	朗らか
ほかんち	補間値
ほかんこ	保管庫
ほおんき	保温器	保温機
ほおぼね	頬骨
ほおべに	頬紅
ほおひげ	髯
ほおづえ	頬杖
ほおずり	頬擦り	ほお擦り
ほおずき	鬼灯	酸漿
ほおじろ	頬白
ほおげた	頬桁
ほえづら	吠え面	吠面
ほうろん	放論
ほうろく	俸禄	焙烙
ほうろう	放浪	琺瑯
ほうれん	法蓮
ほうれつ	放列	芳烈	砲列
ほうれい	豊麗	法令	法例
ほうるい	堡塁
ほうりん	法輪	法林
ほうりな	放り投
ほうりつ	法律
ほうりだ	放り出
ほうりこ	放り込
ほうりき	法力
ほうりあ	放り上
ほうらん	抱卵
ほうらつ	放埒
ほうらく	包絡	法楽	崩落	炮烙
ほうらい	寳来	宝来	蓬莱	鳳来
ほうよく	豊沃
ほうよう	包葉	放鷹	法要	包容	抱擁	苞葉
ほうゆう	邦友	包有	朋友
ほうやし	保谷市
ほうやく	邦訳
ほうもん	訪問	法文	法門	砲門
ほうもつ	宝物
ほうもう	法網
ほうめん	方面	放免
ほうめい	芳名	邦名	法明
ほうむぶ	法務部
ほうむか	法務課
ほうまん	放漫	飽満	豊満
ほうまつ	泡沫
ほうぼく	放牧	芳墨
ほうぼう	謗法	竹麦魚	宝坊	方方	魴ボウ	方々	蜂房	鋒鋩
ほうほく	豊北
ほうほう	方法
ほうべん	方便
ほうべい	訪米
ほうへん	褒貶
ほうへい	砲兵	奉幣
ほうぶん	法文	邦文	報文
ほうぶつ	放物
ほうふん	方墳
ほうふつ	彷彿	髣髴
ほうふく	抱腹	法服	報復
ほうばつ	放伐
ほうばい	傍輩	朋輩
ほうはつ	蓬髪
ほうはく	鵬搏
ほうはい	澎湃	奉拝
ほうのう	奉納
ほうねん	芳年	法然	豊年	芳念	放念
ほうねつ	放熱
ほうにん	放任
ほうにち	訪日
ほうなん	法難	豊南	方南
ほうどく	奉読
ほうどう	報導	報道
ほうとり	放取
ほうとく	宝徳	報徳
ほうとう	宝刀	奉答	放蕩	法灯	包頭	宝塔	砲塔
ほうでん	放電	宝殿
ほうてん	法典	奉天	方転	宝典
ほうてき	法敵	抛擲	法的	放擲
ほうてい	法定	捧呈	奉呈	法廷
ほうづえ	方杖
ほうちく	放逐
ほうちき	報知器	報知機
ほうだん	放談	砲彈	法談	砲弾
ほうだい	邦題	放題	法大	砲台
ほうたん	放胆
ほうたく	飽託
ほうたい	包帯	方体	胞体	奉戴	繃帯
ほうぞう	包蔵	法蔵	宝蔵
ほうそく	法則
ほうそう	放送	法曽	奉送	疱瘡	法曹	包装
ほうぜん	宝前
ほうせん	豊泉	砲戦	法線	芳泉	奉先
ほうせつ	包摂	抱接
ほうせき	宝石
ほうせい	方正	縫製	法制	法政	砲声
ほうすん	方寸
ほうすけ	保介
ほうすう	砲数	鳳雛
ほうすい	豊水	放水
ほうじん	報身	法人	方陣	邦人
ほうじょ	幇助
ほうじゅ	宝珠
ほうしん	疱疹	芳心	砲身	芳信	方針	庖疹	放心
ほうしょ	奉書	邦書	芳書
ほうしゅ	砲手	宝珠	法主
ほうしゃ	報謝	放射	砲車	硼砂
ほうしき	方式	法式
ほうざわ	寶澤
ほうざい	包材
ほうさん	ホウ酸	硼酸	放散
ほうさく	方策	豊作
ほうさか	逢坂
ほうさい	奉斎	朋斎
ほうごう	法号	縫合	抱合
ほうこく	奉告	豊国	報告	邦国	報国
ほうこう	彷徨	奉公	芳香	放校	砲口	咆哮	方向	奉行
ほうげん	法諺	放言	方言	法眼
ほうげき	砲撃	崩撃
ほうげい	奉迎
ほうけん	宝剣	封建	奉献
ほうけい	包茎	方形	法経
ほうぎん	放吟	邦銀
ほうぎょ	崩御
ほうきん	砲金	宝金
ほうきぎ	箒木
ほうがん	砲丸	包含	方眼	判官
ほうがく	法学	方角	放学	邦楽
ほうがい	法外
ほうかん	宝冠	訪韓	幇間	奉還	砲艦	法官	宝鑑
ほうかつ	包括
ほうかご	放課後
ほうかい	法界	崩潰	崩解	抱懐	崩壊
ほうおん	報恩
ほうおく	蓬屋
ほうおう	訪欧	法皇	鳳凰	鳳王	法王
ほうえん	砲煙	豊艶	方円
ほうえつ	法悦
ほうえき	法益
ほうえい	宝永	放映	訪英
ほういん	法印
ほういつ	放逸
ほういち	芳一
ほういさ	方位差
ほうあん	法案	奉安
ほいっぽ	歩一歩
ほいくし	保育士
ほいくき	保育器
ほいくか	保育科
ほあんぶ	保安部
ほあんか	保安課
へんれき	遍歴
へんれい	返戻	返礼
へんりん	片鱗	辺燐
へんらん	変乱
へんよう	遍用	変容
へんやく	変約
へんめい	変名
へんみん	辺民
へんまん	遍満
へんぽん	返本
へんぽう	偏法	返報
へんぼう	偏旁	変貌
へんぺん	辺々	片々	翩々
へんぺい	扁平
へんぷく	蝙蝠	辺幅
へんぶん	変分
へんぴん	返品
へんぱい	返盃	返杯
へんばい	変倍
へんのう	返納
へんねん	編年
へんどう	変動
へんとう	返答	扁桃
へんでん	返電	変電
へんてん	変転
へんてつ	変哲
へんつう	変通
へんちょ	編著
へんたい	編隊	変体	変態
へんぞう	変造
へんそく	変則	変速
へんそう	変奏	返送	変装	変相
へんせん	変遷
へんせつ	変説	変節
へんせい	編制	変声	編成	変性	遍性	変成
へんすう	変数
へんじん	変人	變人
へんじゃ	編者
へんじこ	偏自己
へんしん	返信	遍身	変身	偏心	変心
へんしょ	返書
へんしゅ	変種	騙取
へんしゃ	編者
へんしつ	変質	偏執
へんざい	辺材	偏在	遍在
へんさん	編纂
へんさち	偏差値
へんさい	辺際	返済	変災
へんごう	辺合
へんこう	変項	変更	偏光	変光	偏向
へんげん	変幻	片言
へんけん	偏見
へんけい	辺形	変型	扁形	変形
へんくつ	偏屈
へんきん	返金
へんがく	扁額
へんかん	変換	返環	返還
へんかず	変化図
へんかく	変革	偏角	変格
へんかい	変改
へんおん	変音	変温
へんえん	辺縁
へんえき	変易
へんえい	片影
へんうん	片雲
へんいき	変域
へんあつ	変圧
へんあい	偏愛
へりくつ	屁理屈
へりくだ	遜	謙
へりうむ	Helium	He
へらさぎ	篦鷺
へやわり	部屋割り	部屋割
へやだい	部屋代
へやずみ	部屋住み
へやすう	部屋数
へやかず	部屋数
へびどし	巳年
へびどく	蛇毒
へびくち	蛇口
へばりつ	へばり付
へだたり	隔
へたりこ	へたり込
へたくそ	下手糞
へそのお	臍の緒
へそくり	臍繰り
へしきや	平敷屋
へこおび	兵児帯
へきろん	僻論
へきれき	霹靂
へきらく	碧落
へきめん	壁面
へきはく	璧帛
へきなん	碧南
へきない	壁内
へきとう	劈頭
へきたい	壁体
へきそん	僻村
へきせつ	僻説
へきすう	僻陬
へきすい	碧水
へきじゃ	辟邪
へきけん	僻見
へきくう	碧空
へきがん	壁龕	碧眼
へきかん	壁間
へきかい	劈開	碧海
へきえん	僻遠
へきえき	へき易	辟易
へきうん	碧雲
へいろく	併録
へいれつ	並列
へいりつ	並立
へいらん	兵乱
へいよん	海永
へいよう	並用	併用
へいゆう	併有
へいやぶ	平野部
へいもん	閉門
へいもつ	幣物
へいめん	平面
へいめい	平明
へいみん	平民
へいまく	閉幕
へいぼん	平凡
へいほう	閉包	兵法	平方
へいべい	平米
へいへい	平平	平々
へいぶん	平分	平文
へいふく	平復	平伏	平服
へいふう	弊風
へいばん	平板
へいばい	併売
へいはん	平版
へいはつ	併発
へいはち	平八
へいはく	幣帛
へいねん	平年
へいねつ	平熱
へいにん	併任
へいない	平内
へいどん	併呑
へいどく	併読
へいとう	平等	弊竇
へいてん	閉店	弊店
へいてい	閉廷	平定
へいだん	兵団
へいたん	平淡	平坦	兵站
へいたく	弊宅
へいたい	平体	兵隊
へいぞん	併存	並存
へいぞく	平俗
へいそん	併存	並存
へいそつ	兵卒
へいそく	閉塞	屏息
へいそう	兵装	併走	兵曹	並走
へいぜん	平然	炳然
へいぜい	平生
へいせん	兵船
へいせつ	併設
へいせき	兵籍	平積
へいせい	平成	弊政	平静	兵制	幣制
へいすけ	平助	平祐
へいすう	兵数
へいじん	敝人
へいじょ	平叙
へいじつ	平日
へいしん	平信	平身	並進
へいしょ	弊所	兵書	閉所
へいしゅ	兵種
へいしゃ	兵舎	平射	弊社
へいしき	閉式
へいざん	閉山
へいさぶ	閉鎖部
へいさつ	併殺
へいさく	平朔	平作
へいさい	併催
へいごう	并合	併合
へいこう	並行	平行	併行	閉口	閉項	閉校	敝垢	平向	平衡
へいげん	平原
へいげい	睥睨
へいけつ	併結
へいけい	閉経
へいきん	平均
へいきょ	閉居
へいきち	平吉
へいきこ	兵器庫
へいがん	併願
へいがく	兵学
へいがい	弊害
へいかん	閉管	閉館
へいかつ	平滑
へいかい	閉会
へいおん	平温	併音	平穏
へいおく	弊屋
へいえん	閉宴	閉園
へいえき	兵役
へいえい	兵営	併映
へいいん	閉院	兵員
へいいど	平易度
へいいち	平一
へいいき	閉域
へいあん	平安
へーべー	平米
ふんれい	奮励
ふんらん	紛乱
ふんもん	噴門	憤悶
ふんめつ	焚滅
ふんむき	噴霧器
ふんまん	忿懣	憤懣
ふんまつ	粉末
ふんまえ	分前
ふんぽん	粉本
ふんべん	糞便
ふんべつ	分別
ふんぷん	紛々	芬々
ふんぱん	噴飯
ふんぱつ	奮発
ふんはん	分半
ふんどし	褌
ふんどう	分銅
ふんとう	奮闘
ふんちが	分遅
ふんたん	粉炭
ふんたい	粉黛	粉体
ふんそく	分速	吻側
ふんそう	粉争	扮装	紛争
ふんぜん	憤然	奮然	紛然
ふんせん	奮戦	噴泉
ふんせつ	粉雪
ふんせき	噴石
ふんすい	噴水
ふんじん	奮迅	粉塵
ふんしん	分針
ふんしょ	焚書
ふんしゃ	噴射
ふんしつ	粉失	紛失
ふんざい	粉剤
ふんさつ	焚殺
ふんさい	粉砕
ふんごと	分毎
ふんごう	吻合
ふんころ	分頃
ふんげき	憤激
ふんけい	刎頚	刎頸
ふんがい	憤慨
ふんかん	分間
ふんえん	噴煙
ふんいき	氛圍氣	雰囲気
ふんあつ	分圧
ふわたり	不渡り
ふろんり	負論理
ふろよう	風呂用
ふろふき	風呂吹き
ふろしき	風呂敷
ふろがま	風呂釜
ふろおけ	風呂桶
ふろうじ	浮浪児
ふれんど	普連土
ふれまわ	触れ回
ふれぶみ	触文
ふれはば	振れ幅
ふれこみ	触込み
ふれかく	振れ角
ふれある	触れ歩
ふれあい	ふれ合い
ふるやま	古山
ふるもの	古物
ふるもと	古本
ふるむら	古村
ふるみや	古宮
ふるみち	古道
ふるまち	古町
ふるまい	振舞	振舞い
ふるほん	古本
ふるびら	古平
ふるはた	古畑	古籏
ふるはし	古橋
ふるどり	隹
ふるどの	古殿
ふるとり	隹
ふるでら	古寺
ふるづけ	古漬	古漬け
ふるだて	古舘
ふるだち	古舘
ふるたに	古谷
ふるたて	古舘
ふるたち	古舘	古館
ふるたか	古鷹
ふるそう	古荘
ふるしま	古島
ふるざけ	古酒
ふるさわ	古澤	古沢
ふるさと	故里	故郷	古里
ふるさか	古坂
ふるごう	古国府
ふるくさ	古臭
ふるぎや	古着屋
ふるきず	古傷
ふるがお	古顔
ふるかわ	古川	古河
ふるかぶ	古株
ふるおや	古尾谷
ふるうち	古内
ふるいわ	篩い分
ふるいど	古井戸
ふるいち	古市
ふるいた	奮い起	奮い立
ふるいけ	古池
ふるいえ	古家
ふりわけ	振分	振り分け	振分け
ふりょく	浮力	富力
ふりょう	不良	不漁	不猟
ふりゅう	浮流	風流
ふりむき	振り向き
ふりみだ	振り乱
ふりまわ	振り回
ふりほど	振り解
ふりはら	振り払
ふりはた	降籏
ふりのこ	降り残
ふりにげ	振り逃げ
ふりてん	振聴
ふりつも	降り積
ふりつの	降り募
ふりつづ	降り続
ふりつけ	振り付け	振付け	振付
ふりだし	振出
ふりそぼ	降り濡
ふりそで	振袖	振り袖
ふりそそ	降り注
ふりしぼ	振り絞
ふりしき	降り頻
ふりごま	振り駒
ふりこみ	振り込み	振込み	振込
ふりこう	不履行
ふりがな	振り仮名	振仮名
ふりかた	振り方
ふりかざ	振り翳
ふりかけ	振掛け
ふりかえ	振替	振り返	振返
ふりおと	振り落
ふりえき	不利益
ふりあて	振り当て
ふりあお	振り仰
ふらんす	仏	仏蘭西	佛蘭西
ふらんき	孵卵器
ふらっと	♭
ふようど	腐葉土
ふようい	不用意
ふゆよう	冬用
ふゆやま	冬山
ふゆやす	冬休
ふゆもの	冬物
ふゆみち	冬道
ふゆふく	冬服
ふゆひこ	冬彦
ふゆばれ	冬晴れ
ふゆはる	冬春
ふゆねこ	冬猫
ふゆどり	冬鳥
ふゆぞら	冬空
ふゆざれ	冬ざれ
ふゆごろ	冬頃
ふゆごし	冬越し
ふゆごう	冬号
ふゆこみ	冬コミ
ふゆくさ	冬草
ふゆがれ	冬枯れ
ふゆがた	冬型
ふゆかい	不愉快
ふもうか	不毛化
ふめいよ	不名誉
ふみよし	文良	文義	文嘉
ふみゆき	文之	文行
ふみやす	文保	文康
ふみもち	不身持
ふみまさ	章雅
ふみひろ	文博	文浩	史裕	文礼
ふみひと	史人	文仁
ふみひで	文秀
ふみひこ	文彦	史彦	郁彦
ふみはず	踏み外
ふみのり	文典
ふみのぶ	文信
ふみにじ	踏み躙
ふみなら	踏み均
ふみどの	文殿
ふみとよ	文豊
ふみとど	踏み止
ふみとし	文敏	文俊
ふみづき	文月
ふみつぶ	踏み潰
ふみだん	踏段
ふみだい	踏台	踏み台
ふみただ	文忠
ふみたけ	文武
ふみたか	文隆	文孝
ふみたお	踏み倒
ふみころ	踏み殺
ふみこみ	踏込み	踏み込み	踏みこみ
ふみきり	踏み切り	踏切
ふみがら	文殻
ふみかた	踏み固
ふみかず	文一
ふみいた	踏板
ふみいし	踏石
ふみあけ	文朱
ふみあき	文昭	文明	史光
ふまじめ	不真面目	不まじめ
ふぼかい	父母会
ふほんい	不本意
ふほうわ	不飽和
ふへんか	普遍化
ふへいか	不平家
ふびじん	不美人
ふひょう	浮氷	浮標	不評	歩兵	譜表	附票	付表
ふばらい	不払い
ふねんか	不燃化
ふねよう	船用
ふねへん	舟偏
ふねひき	船引
ふにんち	赴任地
ふにんき	不人気
ふにんか	不妊化
ふにょい	不如意
ふにゅう	腐乳	不入	船生
ふにあい	不似合い
ふなよい	船酔	船酔い
ふなやま	船山	舩山	舟山
ふなやど	船宿
ふなもり	舟盛り
ふなむら	舟村
ふなむし	船虫
ふなみず	船水
ふなまど	船窓
ふなまち	船待ち
ふなべり	船縁	舷
ふなびん	船便
ふなびと	舟人	船人
ふなびき	船曳
ふなばり	船梁
ふなばた	舷	船端
ふなばし	船橋	舟橋
ふなはし	船橋	舟橋
ふなのり	舟乗	船乗り	船乗
ふなぬし	船主
ふなどめ	船留め
ふなづり	船釣	船釣り	舟釣
ふなづみ	船積み
ふなちん	船賃
ふなたび	船旅
ふなぞこ	船底
ふなずし	鮒鮨
ふなさか	舟阪
ふなごや	船小屋
ふなこし	船越
ふなこう	船高
ふなぐら	艙	船蔵	船倉
ふなくぼ	舟久保
ふなくぎ	舟釘
ふながた	舟形	船形
ふなかた	船方
ふなおか	船岡
ふなうた	舟歌
ふないり	舟入
ふないた	船板
ふなあし	船脚	船足
ふなあか	船淦
ふどうい	不同意
ふとわく	太枠
ふともも	太股	太もも
ふともの	太物
ふともじ	太文字
ふとめん	太麺
ふとまき	太巻
ふとどき	不届	不届き
ふとせん	太線
ふとざお	太棹
ふところ	懐	懷
ふとぐち	太口
ふとくぎ	不徳義
ふとくい	不得意
ふとがき	太書き
ふでんき	負電気
ふでもじ	筆文字
ふでぺん	筆ペン
ふでぶと	筆太
ふでばこ	筆箱
ふでづか	筆遣
ふでたて	筆立て
ふでさき	筆先
ふでいれ	筆入れ
ふてぶて	太々
ふてくさ	不貞腐	ふて腐
ふてぎわ	不手際
ふていち	不定値
ふていし	不定詞
ふていき	不定期
ふづくえ	文机
ふつれき	仏暦
ふつぶん	仏文
ふつふつ	沸々	沸沸
ふつつか	不束
ふつじん	仏人
ふつしゃ	仏車
ふつごう	不都合
ふつぐん	仏軍
ふつかよ	二日酔
ふつかめ	二日目
ふつかご	二日後
ふつうば	普通馬
ふつうし	普通紙
ふつうか	不通過	普通科
ふついん	仏印
ふっとう	沸湯	沸騰
ふってん	沸点
ふってわ	降って湧
ふってい	払底
ふっせき	沸石
ふっさし	福生市
ふっこく	覆刻	復刻
ふっこう	復航	復交	復興	腹腔	復校
ふっけん	福建	復権
ふっきん	腹筋
ふっきち	復帰値
ふっかん	副官	復刊
ふっかつ	復活
ふっかく	伏角
ふっかい	復改
ふちょう	府庁	符丁	婦長	不調	符牒
ふちゅう	釜中	婦中	不忠	府中
ふちゃく	付着	不着
ふちまい	扶持米
ふちのべ	渕野辺	淵野辺
ふちなし	縁無し
ふちどり	縁取り
ふちざき	渕崎
ふちけん	付置研
ふちがみ	渕上
ふだんぎ	不断着	普段着
ふだらく	補陀洛	普陀落	補陀落
ふだどめ	札止	札止め
ふだつき	札付き	札付
ふだしょ	札所
ふたんぽ	不担保
ふたりめ	二人目
ふたやく	二役
ふたもじ	二文字
ふたむら	二村
ふたみち	二道
ふたまた	二又	二叉	二股
ふたませ	二間瀬
ふたへや	二部屋
ふたばん	二晩
ふたはこ	二箱
ふたなり	二形
ふたとお	二通
ふたつや	二ッ谷
ふたつめ	二つ目	二つめ
ふたつぎ	二木
ふたつき	二月
ふたつい	二ツ井
ふたたま	二玉
ふたたび	再び
ふたすじ	二筋
ふたしか	不確か
ふたござ	双子座
ふたこと	二言
ふたけた	二桁
ふたくみ	二組
ふたくせ	二癖
ふたがわ	二川
ふたがみ	二神	二上
ふたかわ	二川
ふたかみ	二上
ふたかた	二方
ふたおや	二親
ふたえき	二駅
ふたあじ	二味
ふたあし	二足
ふたあけ	蓋明け
ふたあい	二藍
ふぞろい	不揃い
ふぞくし	付属肢
ふぞくご	附属語	付属語
ふそくじ	不足時
ふせんし	付箋紙
ふせいび	不整備
ふせいち	不整地
ふせいき	不正規
ふずいご	付随語
ふずいか	付随果
ふずいい	不随意
ふすまえ	襖絵
ふじんぶ	婦人部
ふじんか	婦人科
ふじわら	冨士原	藤原
ふじわか	藤若
ふじれい	負事例
ふじよし	藤吉
ふじょし	婦女子
ふじょう	不浄	不定	浮上
ふじゆう	不自由
ふじゅん	不順	不純
ふじゅり	不受理
ふじゅつ	巫術
ふじゅく	不熟
ふじゅう	藤生
ふじやま	藤山
ふじもり	藤森
ふじもと	藤元	藤本
ふじむら	藤村
ふじまめ	藤豆
ふじまつ	藤松
ふじまき	藤巻
ふじひろ	不二洋
ふじひこ	不二彦
ふじはら	冨士原
ふじはし	藤橋
ふじなわ	藤縄
ふじなみ	藤波
ふじなが	藤永
ふじづか	富士塚
ふじつぼ	藤壷
ふじつか	藤塚
ふじつう	富士通
ふじだな	藤棚
ふじたに	藤谷	富士谷
ふじたか	藤孝
ふじしろ	藤代	藤城
ふじしま	藤嶋	藤島
ふじさん	富士山
ふじさわ	藤沢	藤澤
ふじさと	藤里
ふじさく	藤咲
ふじさき	藤崎
ふじごこ	富士五湖
ふじこし	不二越	藤越
ふじけい	フジ系
ふじくら	藤倉
ふじぎん	富士銀
ふじがわ	富士川
ふじかわ	藤川	富士川
ふじかけ	藤懸	藤掛
ふじおか	藤岡	富士岡
ふじえだ	藤枝
ふじうら	藤浦
ふじいろ	藤色
ふじいち	富士市
ふしんび	不審火
ふしよう	不使用
ふしょく	腐食	腐蝕	扶植	不食
ふしょう	父称	不祥	不詳	不承	負傷	不肖	不精
ふしゅび	不首尾
ふしゅつ	不出
ふしゅう	腐臭	俘囚
ふしみく	伏見区
ふしまわ	節回
ふしまつ	不始末
ふしぶし	節々
ふしてん	節点
ふしづけ	罧	節付け
ふしたに	伏谷
ふしぜん	不自然
ふしくれ	節榑
ふしいと	節糸
ふしあな	節穴
ふざいじ	不在時
ふさんか	不参加
ふさふさ	房々
ふさくい	不作為
ふさぎこ	塞ぎ込
ふさきち	房吉
ふさがる	閼
ふごうり	不合理
ふごうご	符号語
ふごうき	符号器
ふごうか	符合化	符号化
ふけやく	老け役	老役
ふけっか	不結果
ふけいき	不景気
ふぐじる	河豚汁
ふぐしゃ	不具者
ふぐあい	不具合
ふくろば	袋貼
ふくろど	袋戸
ふくろと	袋綴
ふくろだ	袋田
ふくろう	梟
ふくろい	袋井
ふくれあ	膨れ上
ふくりき	福力
ふくらい	福来
ふくよし	福吉
ふくよか	脹よか	膨よか
ふくよう	服用	複葉
ふくやま	富久山	福山
ふくやす	福安
ふくやく	服薬
ふくもり	福盛
ふくもと	福元	福本
ふくめん	覆面
ふくめに	含め煮
ふくめつ	覆滅
ふくめい	復命
ふくむら	福村
ふくみみ	福耳
ふくみつ	福光
ふくまめ	福豆
ふくまつ	福松
ふくます	福桝
ふくまさ	福政
ふくまく	腹膜
ふくぼつ	覆没
ふくぼく	副木
ふくほん	複本	副本
ふくほう	複方	副砲
ふくへき	腹壁
ふくへい	伏兵
ふくぶん	副文	復文	複文	福分
ふくぶく	福々
ふくびき	福引
ふくはら	復原	福原
ふくはい	腹背	復配
ふくにし	福西
ふくなが	福永
ふくどみ	福富
ふくどく	副読	服毒
ふくとめ	福留
ふくとみ	福富
ふくとく	福徳
ふくとう	復党
ふくでん	復電
ふくつう	腹痛
ふくちじ	副知事
ふくだい	福大	副題
ふくたに	福谷
ふくたけ	福武
ふくたい	腹帯	複体
ふくぞく	服属
ふくぞう	腹蔵	福蔵
ふくそく	腹側
ふくそう	副葬	輻輳	複相	複層	服装	副層	輻湊	福相
ふくせん	複線	伏線
ふくせつ	副節
ふくせき	復席	復籍
ふくせい	服制	複製	復姓
ふくずみ	福住
ふくすけ	福助
ふくすう	複数
ふくすい	覆水	腹水
ふくじん	副腎	副神
ふくじゅ	福寿
ふくしん	副審	復申	腹心
ふくしょ	副書	副署
ふくしゅ	副手
ふくしゃ	輻射	伏射	複写	福者
ふくしま	福島	副島	福嶋
ふくしげ	福重
ふくしく	副詞句
ふくしき	腹式	複式
ふくしか	福祉課
ふくざわ	福沢	福澤
ふくざつ	複雑
ふくざき	福崎
ふくざい	服罪	伏在
ふくさわ	福澤
ふくさや	福砂屋
ふくさい	副菜
ふくごう	複号	復号	複合
ふくこう	腹腔
ふくげん	復原	復元
ふくけん	復権
ふくけい	復啓
ふくくう	腹腔
ふくがん	複眼
ふくがみ	福紙
ふくがく	復学
ふくかん	副官
ふくかわ	福川
ふくおん	複音
ふくおか	福岡
ふくおう	福王
ふくえん	復縁	復円
ふくえき	服役
ふくうん	福運
ふくいん	福音	復員	副因	幅員
ふくいし	福井市
ふくあん	腹案
ふくあつ	腹圧
ふぎかい	府議会
ふきわた	吹き渡
ふきょか	不許可
ふきょう	布教	富強	不協	不況	不興
ふきゅう	普及	不朽	腐朽	不急	不休
ふきもの	吹物
ふきぶり	吹き降り
ふきはつ	不揮発
ふきぬけ	吹抜	吹抜け
ふきなが	吹き流
ふきとお	吹き通
ふきつづ	吹き続
ふきつけ	吹付け
ふきだま	吹き溜
ふきだし	吹き出し	吹出
ふきそく	不規則
ふきすさ	吹き荒
ふきさら	吹き曝
ふきごし	吹越
ふきこし	吹越
ふきげん	不機嫌
ふきかん	負帰還
ふきかえ	吹替え	吹替	吹き返
ふきいど	噴井戸
ふきあげ	吹上げ	吹上
ふがひな	腑甲斐無
ふがいな	腑甲斐無
ふかんび	不完備
ふかんず	俯瞰図
ふかりつ	孵化率
ふかよみ	深読み
ふかやま	深山
ふかやし	深谷市
ふかみず	深水
ふかまち	深町
ふかぶん	不可分
ふかぶか	深々
ふかはた	深畑
ふかのう	不可能
ふかなべ	深鍋
ふかなさ	深情
ふかてん	付加点
ふかてき	付加的
ふかづめ	深爪
ふかつか	不活化
ふかたに	深谷
ふかぞり	深剃り
ふかそく	不可測
ふかぜい	附加税	付加税
ふかせつ	不可説
ふかすぎ	深過ぎ
ふかしん	不可侵
ふかしぎ	不可思議
ふかざわ	深澤	深沢
ふかざら	深皿
ふかざけ	深酒
ふかさわ	深澤	深沢
ふかさく	深作
ふかこう	付加項
ふかけつ	不可欠
ふかくさ	深草
ふかきん	賦課金	付加金
ふかがわ	深川	負荷側
ふかかち	付加価値
ふかかい	不可解
ふかおい	深追い
ふかうら	深浦
ふかいり	深入り
ふかいし	深石
ふおうき	不応期
ふぉるて	forte
ふえふき	笛吹き
ふえかた	増え方
ふぇむと	femto
ふうろう	封蝋	風浪
ふうれん	風連
ふうりん	風鈴
ふうらい	風来
ふうもん	風紋
ふうぼう	風防	風貌
ふうぶん	風聞
ふうぶつ	風物
ふうはつ	風発
ふうはく	風伯
ふうどう	風洞
ふうとう	風濤	封筒
ふうてん	瘋癲
ふうてい	風体
ふうつう	風通
ふうちん	風鎮
ふうたく	風鐸
ふうたい	風帯	風体	風袋
ふうぞく	風俗
ふうそく	風速
ふうそう	風霜	風騒	風葬
ふうぜん	風前
ふうせん	風船
ふうせつ	風説	風雪
ふうせい	風勢	風声
ふうすい	風水
ふうじん	風塵	風神
ふうじゅ	風樹
ふうじて	封じ手
ふうじこ	封じ込
ふうしん	風疹
ふうしょ	封書
ふうしゅ	風趣
ふうしゃ	風車
ふうしつ	風湿
ふうしえ	風刺絵
ふうさつ	封殺
ふうさい	風采	風災
ふうこう	風向	風光
ふうげつ	風月
ふうけつ	風穴
ふうけい	風景
ふうぎり	封切り
ふうきん	風琴
ふうきり	封切	封切り
ふうがん	風眼
ふうがわ	風変
ふうがら	風柄
ふうがい	風害
ふうかん	封緘	風乾
ふうかく	風格
ふうかい	風解	諷戒	風懐
ふうえい	風営	諷詠
ふううん	風雲
ふういん	封印	風韻
ふういき	風域
ふうあつ	風圧
ふうあい	風合
ふいっち	不一致
ふいうち	不意打	不意打ち
ふぃーと	呎
ふあんし	不安視
ふあんげ	不安気
ひんよう	頻用
ひんもく	品目
ひんめい	品名
ひんみん	貧民
ひんぴん	頻々
ひんぱん	頻繁
ひんぱつ	頻発
ひんぱく	頻拍
ひんばん	品番
ひんのう	貧農
ひんどち	頻度値
ひんとう	品等
ひんそん	貧村
ひんそう	貧相
ひんせい	稟性	品性
ひんじゃ	貧者
ひんしゅ	品種
ひんしつ	稟質	品質
ひんこん	貧困
ひんこう	品行	貧鉱
ひんけつ	貧血
ひんけい	牝系
ひんかく	賓客	品格
ひんかい	頻回
ひわちゃ	鶸茶
ひわたり	火渡り	樋渡	日渡
ひわせい	秘話性
ひわさき	日和崎
ひわいろ	鶸色
ひろよし	敬昌	浩由	浩喜	博喜	弘恭	寛善	博芳	博義
ひろゆき	宏幸	裕行	洋征	宏之	裕由	啓之	寛之	祐之	弘征	周行	広幸	宏行	弘之	弘幸	弘恭	幸展	裕之	浩之	博幸	博之	浩幸	広行	洋之	弘行	博行	陽之	裕幸	広之
ひろやす	浩康	博保	博泰	容靖	弘康	弘安	裕康	大和	浩靖	博康
ひろもち	裕望
ひろみつ	宏光	廣光	博允	広光	弘光	博三	博満	博光
ひろみち	拓路	博道	弘道	広道	晃道	寛道
ひろまど	広窓
ひろまつ	広松	廣松
ひろまさ	宏昌	裕昌	弘昌	弘征	裕真	弘真	広正	洋正	浩正
ひろまえ	広前
ひろぶみ	弘史	博文	浩史
ひろふみ	寛文	洋典	啓文	宏文	弘史	廣文	大史	洋史	洋文	弘文	博文	裕文	博史
ひろびろ	広々
ひろひと	宏仁	裕仁	博人	裕人
ひろひさ	浩久	裕久	博久	浩寿
ひろひこ	浩彦	洋彦	恕彦	裕彦	飛呂彦	博彦
ひろはら	広原
ひろはば	広幅
ひろはし	広橋
ひろのり	浩則	博典	弘法	裕徳	博徳	博紀	広徳	博則
ひろのぶ	弘宣	博宣	広宣	宏伸	博信	裕信	弘宜
ひろなが	広長
ひろなか	広中	弘仲	弘中
ひろなお	弘直	弘尚
ひろとも	弘具	寛知
ひろとし	宏寿	浩俊
ひろでん	広電
ひろつぐ	裕次	博次	博嗣
ひろだい	弘大	広島大学	広大
ひろたに	広谷
ひろたつ	広達
ひろただ	博唯	裕忠
ひろたけ	博丈
ひろたき	広瀧
ひろたか	宏高	浩孝	弘崇	博孝	浩貴	宏隆	宏貴	宏孝	弘隆
ひろぞう	弘蔵
ひろそで	広袖
ひろすえ	広末
ひろしま	広島
ひろしげ	浩重	博茂	広重
ひろさわ	廣澤	広沢	廣沢
ひろさと	宏郷	浩郷
ひろさき	弘前	広崎
ひろさか	広坂
ひろくに	裕邦
ひろくち	広口
ひろきち	広吉
ひろがわ	広川
ひろかわ	広川	廣川	紘川
ひろかみ	広神
ひろかず	泰一	大一	博和	博一	弘一	博万	浩一	裕和	浩和	宏和
ひろおか	広岡	弘岡
ひろえん	広縁
ひろうど	疲労度
ひろうち	浩内
ひろいよ	拾い読
ひろいだ	拾い出
ひろいし	広石
ひろいご	拾い子
ひろいけ	広池	廣池
ひろいあ	拾い上
ひろあき	博明	博昭	浩昭	祐彰	裕章	浩明	宏昭	宏明	寛明	弘朗	裕昭	裕明	洋昭	祐昭	洋明	啓明	博章	宏晃	弘明	洋晶	広章	宏朗	広昭	広明	浩晃	弘昭	浩秋	宏顕	広朗
ひれにく	ヒレ肉
ひれいく	比例区
ひるやす	昼休
ひるめし	昼飯
ひるまえ	昼前
ひるなか	昼中
ひるどき	昼時
ひるてい	昼定
ひるぜん	蒜山
ひるせん	蒜山
ひるすぎ	昼過	昼過ぎ
ひるざけ	昼酒
ひるさが	昼下
ひるごろ	昼頃
ひるころ	昼頃
ひるがた	昼型
ひるがお	昼顔
ひるがえ	飜	翻
ひるかわ	蛭川	比留川
ひるいち	昼一
ひりょく	臂力	非力
ひりょう	肥料
ひりゅう	飛竜	飛龍
ひらやま	平山
ひらもと	平本
ひらめき	閃き
ひらみつ	平光
ひらみち	平道
ひらまつ	平松
ひらまく	平幕
ひらぶん	平文
ひらふく	平福
ひらひも	平紐
ひらばる	平原
ひらばり	平針
ひらはら	平原
ひらはし	平橋
ひらぬま	平沼
ひらにわ	平庭
ひらなべ	平鍋
ひらなが	平長
ひらなか	平中
ひらない	平内
ひらどま	平土間
ひらとり	平取
ひらとじ	平綴じ
ひらづみ	平積み
ひらつぼ	平坪
ひらつか	平塚
ひらだい	平台
ひらたに	平谷
ひらたけ	平茸
ひらぞこ	平底
ひらじろ	平城
ひらしま	平島	平嶋
ひらざわ	平澤
ひらざら	平皿
ひらさん	比良山
ひらさわ	平澤	平沢
ひらこう	平光
ひらぎぬ	平絹
ひらきど	開き戸
ひらがな	平假名	平仮名
ひらかわ	平河	平川
ひらかな	平仮名
ひらかた	枚方	平形
ひらおり	平織り	平織
ひらおし	平押し
ひらおか	平岡
ひらうち	平打
ひらいわ	平岩
ひらいで	平出
ひらいし	平石
ひよりみ	日和見
ひよどり	鵯
ひようか	費用化
ひょうり	表裏
ひょうよ	票読
ひょうま	豹馬
ひょうぶ	兵部
ひょうひ	表皮
ひょうど	表土
ひょうじ	標示	表示	憑恃	票時
ひょうし	拍子	表紙
ひょうさ	票差
ひょうご	標語	兵庫	評語
ひょうぐ	表具	表組
ひょうぎ	評議
ひょうき	表記	氷期	標記	兵機
ひょうが	氷河
ひょうか	評価	瓢果	氷花	評家	氷菓
ひょうえ	兵衛
ひょうい	憑依	表意
ひゆてき	比喩的
ひゆうり	非有理
ひゅうま	飛雄馬
ひゅうが	日向
ひややか	冷やか
ひやめし	冷や飯	冷飯
ひやむぎ	冷麦
ひやみづ	冷水
ひやみず	冷や水	冷水
ひやひや	冷や冷や
ひやとい	日雇い
ひやざけ	冷酒	冷や酒
ひやあせ	\(^_^；	冷汗
ひゃっぽ	百歩
ひゃっき	百鬼
ひゃっか	百家	百科	百貨	百花
ひゃくり	百里
ひゃくめ	百目
ひゃくみ	百味
ひゃくど	百度
ひゃくじ	百事
ひゃくい	百位
ひもんや	碑文谷
ひもんじ	緋文字
ひもよう	紐用
ひもつき	紐付き
ひめゆり	姫百合
ひめみや	姫宮
ひめまつ	姫松
ひめのぎ	姫ノ樹	姫乃樹
ひめのき	姫乃樹
ひめじま	姫嶋
ひめじし	姫路市
ひめしま	姫島
ひめさま	姫様
ひめごと	秘め事
ひめぎみ	姫君
ひめがわ	姫川
ひめかわ	姫川
ひむかい	日向
ひみょう	秘妙
ひみつり	秘密裡	秘密裏
ひみつど	秘密度
ひみせん	氷見線
ひまんじ	肥満児
ひまわり	向日葵
ひまつり	火祭
ひまつぶ	暇潰
ひまじん	閑人	暇人
ひましゆ	ヒマシ油	ひまし油	蓖麻子油
ひましに	日増しに
ひぼたん	緋牡丹
ひほうわ	非飽和
ひぶんは	非文派
ひぶそう	非武装
ひふやく	皮膚薬
ひふこう	非負項
ひふくぎ	被覆木
ひふくき	被覆木
ひふがん	皮膚癌
ひふかい	皮膚科医
ひふえん	皮膚炎
ひひょう	批評
ひばしら	火柱
ひばくち	被爆地
ひはなち	樋放
ひのもり	日野森
ひのもと	日の本	火の元
ひのまる	日の丸
ひのばし	日野橋
ひのはる	日之春
ひのはら	桧原
ひのとり	火の鳥
ひのとみ	丁巳
ひのとう	丁卯
ひのとい	丁亥
ひのたま	火の玉
ひのくま	日隈
ひのくち	樋ノ口	樋の口
ひのかげ	日之影
ひのおか	日ノ岡
ひのえね	丙子
ひのうみ	火の海
ひのうち	日の中
ひのいり	日の入り	日入
ひねりだ	捻り出
ひねもす	終日
ひにんぐ	避妊具
ひにゅう	泌乳
ひならず	日ならず
ひなもと	雛元
ひなどり	雛鳥
ひなだん	雛壇
ひなずし	雛鮨
ひなげし	雛罌粟
ひなぎく	雛菊
ひながた	ひな形	雛型	ひな型	雛形
ひなあそ	雛遊
ひどけい	日時計
ひどうじ	非同時
ひどうき	非同期
ひとりめ	一人目
ひとりみ	独り身
ひとりね	独り寝
ひとりだ	独り立
ひとりじ	一人占	独り占
ひとりぐ	一人暮
ひとりい	独り居
ひとよせ	人寄せ
ひとよし	人吉
ひとやま	人山	一山
ひとやす	一休
ひとやく	一役
ひともじ	人文字	一文字
ひとめぼ	一目惚
ひとむら	一叢
ひとむね	一棟
ひとみし	人見知
ひとまわ	一回
ひとまろ	一麿	人麿	人麻呂
ひとまね	人真似
ひとまち	人待ち
ひとまく	一幕
ひとまき	一巻
ひとまか	人任
ひとまえ	人前
ひとほね	一骨
ひとへや	一部屋
ひとふろ	一風呂
ひとふり	一振り
ひとふゆ	一冬
ひとふで	一筆
ひとふし	一節
ひとびと	人々	人びと
ひとひら	一枚	一片
ひとひね	一捻
ひとばん	一晩
ひとばら	人払
ひとばし	人橋
ひとはな	一花
ひとはだ	人肌	一肌
ひとはた	一旗
ひとはし	一走
ひとはこ	一箱
ひとのみ	一飲み
ひとねむ	一眠
ひとねい	一寝入
ひとにぎ	一握
ひとなり	仁成
ひとなみ	人並	人波
ひとなど	人等
ひとなつ	一夏	人懐
ひとなか	人中
ひとどお	人通
ひととび	一飛び
ひととせ	一年	稘
ひととき	一時
ひととお	一通
ひととう	一通
ひとづま	人妻
ひとづて	人伝
ひとづき	人付き
ひとづか	人使
ひとつら	一連	一列	一行
ひとつや	一つ家
ひとつめ	一つ目	一つめ
ひとつみ	一つ身
ひとつぶ	一粒
ひとつづ	一続
ひとつぎ	一木
ひとつき	一月
ひとっこ	人っ子
ひとちが	人違
ひとだま	人魂
ひとだす	人助
ひとだか	人集
ひとたま	一溜	一玉
ひとたび	一度
ひとたば	一束
ひとたち	人達	一太刀
ひとたた	一叩
ひとそろ	一揃
ひとずき	人好き
ひとすじ	一筋
ひとじに	人死に	人死
ひとじち	人質
ひとしな	一品
ひとしお	一入	一塩
ひとしい	等しい
ひとざと	人里
ひとさわ	人騒	一騒
ひとさら	一皿	人攫
ひとさま	人様
ひとさが	人捜	人探
ひとごろ	人殺
ひとごみ	人込み	人混み
ひとごと	人事	他人事
ひとごえ	人声
ひところ	ひと頃	一頃
ひとこま	一齣
ひとこと	一言
ひとこえ	一声
ひとこい	人恋
ひとけた	1桁	一桁
ひとくら	一庫
ひとくみ	一組
ひとくち	一口
ひとくせ	一癖
ひとくぎ	一区切
ひとくい	人食	非特異
ひとぎら	人嫌
ひとぎき	人聞き
ひときわ	一際
ひときり	人斬り	一切り
ひとがら	人柄
ひとがた	人型	人像	人形
ひとがき	人垣
ひとかん	一缶
ひとかわ	一皮
ひとかぶ	一株
ひとかど	一廉
ひとかた	一方
ひとかず	人数
ひとかげ	人影
ひとかか	一抱
ひとかい	人買い
ひとおも	一思
ひとおと	人音
ひとおじ	人怖じ
ひとえに	偏に
ひとえき	一駅
ひとうか	非透過
ひといろ	人色	一色
ひといき	一息
ひとあわ	一泡
ひとあれ	一荒れ
ひとあめ	一雨
ひとあな	一穴	人穴
ひとあせ	一汗
ひとあじ	一味
ひとあし	一足
ひとあき	仁明
ひでんし	非電子
ひでんか	非電化	比電荷	妃殿下
ひでろう	秀郎
ひでより	秀頼
ひでよし	秀吉	秀善
ひでゆき	秀行	英行	秀幸	秀之	英之	英幸
ひでやす	英育	秀康	秀育
ひでもと	秀基
ひでみつ	秀光	英光
ひでまる	秀丸
ひでまさ	豪将
ひでふみ	秀文
ひでひろ	秀宏	秀浩	秀博	英裕	英宏
ひでひと	英仁	秀仁
ひでひさ	秀寿
ひでひこ	英彦	秀彦
ひではる	英晴	英治
ひでのり	秀典	英紀	秀紀	秀則	英憲	英則	英典
ひでのぶ	英信	秀信
ひでなお	秀尚
ひでとも	秀智	英智
ひでとし	英敏	秀敏	秀利	英俊	秀年
ひでつぐ	秀嗣	秀次
ひでたつ	英辰
ひでただ	秀忠
ひでたか	栄孝	秀貴	英孝	英卓	秀孝	秀隆
ひでぞう	秀三
ひでずみ	秀純
ひでさと	秀郷
ひでさち	秀幸
ひでさく	秀作
ひできよ	英清
ひできち	秀吉
ひでかつ	秀勝	英勝
ひでかず	英和	秀一	秀和	英一
ひでおき	秀起
ひでいち	秀市
ひであき	秀昭	英亮	英朗	英明	秀章	英昭	秀明
ひていは	否定派
ひつよう	必用	必要
ひつめつ	必滅
ひつめい	筆名
ひつぼく	筆墨
ひつひつ	謐謐
ひつばつ	必罰
ひつねい	謐寧
ひつどく	必読
ひつだん	筆談
ひつぜん	謐然	必然	□
ひつぜつ	筆舌
ひつじん	筆陣
ひつじゅ	必需
ひつうち	非通知
ひつあつ	筆圧
ひっぽう	筆鋒	筆法
ひっぱり	引張
ひっぱつ	必発
ひっぱく	逼迫
ひっぱい	必敗
ひっとら	引っ捕
ひっとう	筆頭	筆答
ひってき	匹敵
ひっつめ	引っ詰め
ひったん	筆端
ひったく	引っ手繰
ひっそく	逼塞
ひっせん	筆戦	筆洗
ひっせき	筆跡	筆蹟	筆迹
ひっせい	筆生	筆勢	畢生
ひっすう	必須
ひっすい	必衰
ひっしゃ	筆者	筆写
ひっさん	筆算
ひっさつ	必殺
ひっこみ	引込み
ひっこぬ	引っこ抜
ひっこし	引越し	引越	引っ越し
ひっこう	筆耕
ひっけん	必見	筆硯
ひっけい	必携
ひっくる	引っ括
ひっくく	引っ括
ひっきぐ	筆記具
ひっかぶ	引っ被
ひっかけ	引っ掛け
ひっかく	筆画
ひっかか	引掛	引っ掛
ひちりき	篳篥
ひちょう	飛鳥	悲調
ひちゅう	秘中
ひちそう	七宗
ひちしゃ	被治者
ひだるま	火だるま	火達磨	火ダルマ
ひだりよ	左寄	左四
ひだりや	左矢	←
ひだりめ	左目
ひだりむ	左向
ひだりま	左巻
ひだりて	左手
ひだりず	左図
ひだりき	左利	左効
ひだまり	日溜り	日溜まり	陽溜り
ひだいか	肥大化
ひたむき	直向	直向き
ひたぶる	頓	一向
ひたはし	直走
ひたちし	日立市
ひたたれ	直垂
ひたすら	頓	只管	一向
ひたかく	直隠
ひぞっこ	秘蔵っ子
ひぞうか	非増加
ひそやか	密やか
ひそすう	非素数
ひそかに	窃
ひそうび	悲壮美
ひせいじ	非斉次
ひじょう	非情	非常
ひじゅん	批准
ひじゅつ	秘術
ひじゅう	比重
ひじみん	非自民
ひじてつ	肘鉄
ひじかわ	肱川
ひじかた	土方
ひじかけ	肘掛け	肘掛
ひじうち	肘撃
ひじあて	肘当	肘当て
ひしょち	避暑地
ひしょく	比色	非職
ひしょか	秘書科	秘書課
ひしょう	飛翔	悲傷	卑小	費消
ひしゅう	悲愁	飛州
ひしゃく	柄杓	杓
ひしもち	菱餅
ひしまく	皮脂膜
ひしひし	犇々	緊々
ひしぬま	菱沼
ひしせん	皮脂腺
ひしがた	◇	菱形
ひしかわ	菱川
ひしかり	菱刈
ひしおす	醤酢
ひざもと	ひざ元	膝元
ひざまづ	跪
ひざまず	跪
ひざした	膝下
ひざかり	日盛り
ひざかけ	膝掛け
ひざうえ	膝上
ひざあて	膝当て
ひさよし	久吉	久佳
ひさゆき	尚幸
ひさやま	久山
ひさもと	久本
ひさむら	久村
ひさみつ	久光
ひさみち	久道
ひさまつ	久松
ひさべつ	被差別
ひさびさ	久々
ひさひろ	久浩	久寛
ひさひこ	寿彦
ひさはる	寿春	尚玄
ひさはら	久原
ひさのり	久寛	寿憲	久典	尚典	寿則
ひさのぶ	久信
ひさなが	久永	久長
ひさなお	久尚
ひさどめ	久留
ひさとめ	久留
ひさとみ	久富
ひさとし	久敏	尚敏
ひさたか	尚敬
ひさずみ	久住
ひさしま	久島
ひさしぶ	久し振
ひさした	久下
ひさくに	久国
ひさきち	久吉
ひさかわ	久川
ひさかど	久門
ひさかた	久方
ひさかず	久一	永和	久和
ひさいち	被災地
ひさいし	久石
ひさあき	久昭
ひごばし	肥後橋
ひごかん	非互換
ひごうり	非合理
ひこぼし	彦星
ひこばえ	蘖
ひこなり	彦生
ひこてい	非固定
ひこじん	非個人
ひこじま	彦島
ひこしま	彦島
ひこうち	非公知
ひこうし	飛行士
ひこうさ	非交差
ひこうき	飛行機
ひこうか	非行化
ひげづら	髭面
ひげそり	髭剃り
ひげくろ	髭黒
ひけぎわ	引け際
ひぐらし	蜩	日暮し	茅蜩	日暮
ひくいな	緋秧鶏	緋水鶏
ひぎょう	罷業
ひぎゃく	被虐
ひぎしゃ	被疑者
ひきわり	挽き割り	引き割り	碾き割り	引割	引割り
ひきわた	引き渡	引渡
ひきわけ	引分	引き分け
ひきょり	飛距離
ひきょく	秘曲	悲曲
ひきょう	悲境	悲況	卑怯	秘境	秘教	比況
ひきゅう	秘笈	飛球
ひきやま	引山
ひきゃく	飛脚
ひきもの	引物
ひきもど	引き戻
ひきむす	引き結
ひきまわ	引き回
ひきまく	引幕
ひきふだ	引札
ひきはら	引き払
ひきぬき	引き抜き
ひきにげ	ひき逃げ	轢き逃げ
ひきにく	挽肉	挽き肉
ひきなお	引き直
ひきどき	引き時
ひきとり	引き取り
ひきとお	引き通
ひきつる	痙
ひきつづ	引き続	引続
ひきつけ	痙	引付け
ひきつぎ	引きつぎ	引き継ぎ
ひきちぎ	引き千切
ひきだし	抽斗	引き出し	抽出	引出し
ひきたて	引立て
ひきたお	引倒	引き倒
ひきぞめ	弾き初め
ひきすう	引数	引き数
ひきしめ	引き締め	引締め
ひきしぼ	引き絞
ひきしお	引き汐	引き潮
ひきざん	引算	引き算
ひきさげ	引下げ
ひきごと	引言
ひきごう	非記号
ひきころ	轢き殺
ひきこみ	引込	引き込み
ひきげき	悲喜劇
ひきぐん	比企郡
ひきぎわ	引き際
ひきがわ	日置川
ひきがね	引き金	引金
ひきがた	弾き語
ひきかた	挽き方	引き方	弾き方
ひきかえ	引換	引替	引き換え	引き返	引替え
ひきおと	引き落
ひきおこ	引き起	引き起こ
ひきうつ	引き写
ひきうた	引歌
ひきうけ	引受け	引受	引き受け
ひきあわ	引き合
ひきあみ	引き網	引網	曳き網
ひきあて	引き当て	引当	引当て
ひきあげ	引き上げ
ひきあけ	引明け
ひきあい	引合い	引き合い	引合
ひがんえ	彼岸会
ひがわり	日替わり	日変わり
ひがしむ	東向
ひがしの	東野
ひがしね	東根
ひがしだ	東田
ひがしく	東区
ひがしお	東尾
ひがえり	日帰り
ひかんり	非管理
ひかんじ	非漢字
ひかんし	悲観視
ひかぜい	非課税
ひかさん	非可算
ひかげん	火加減
ひかくき	比較器
ひかくか	非核化
ひかきん	非課金
ひかがみ	膕
ひかかん	非可換
ひかかい	非可解
ひかえめ	控え目
ひおとこ	火男
ひおおい	日覆い
ひおうぎ	檜扇
ひえびえ	冷え冷え
ひえぬき	稗貫
ひえこみ	冷えこみ
ひえいり	非営利
ひいんじ	非印字
ひいらぎ	柊
ひいまご	曾孫
ひいては	延いては
ひいぞん	非依存
ひいじじ	曽祖父
ひいきめ	贔屓目
ひあんだ	被安打
ひあぶり	火焙り
ひあたり	日当り	陽当り	日当たり	陽当たり
ひあそび	火遊び
はんろん	汎論	反論
はんろう	煩労	藩老
はんれつ	半列
はんれい	凡例	範例	判例	汎例	煩禮	反例
はんるい	煩累
はんりん	半輪
はんりょ	伴侶
はんりつ	反立
はんらん	汎濫	反乱	氾濫	叛乱
はんらく	反落
はんよう	繁用	汎用
はんやけ	半焼け
はんやく	反訳
はんやき	半焼き
はんもん	煩悶	半文	斑紋	反問
はんもと	版元
はんもく	反目
はんもう	半盲	反毛
はんめん	半面	版面	反面
はんめい	判明
はんむら	半村
はんまい	飯米
はんぽん	版本	翻本
はんぼう	繁忙
はんぺん	半平	反変	半片
はんぺい	汎平	藩屏
はんべつ	判別
はんべそ	半ベソ	半べそ
はんべえ	半兵衛
はんべい	反米
はんぷく	反復	反覆
はんぶん	繁文	半分
はんびら	半開
はんひん	販品
はんぱつ	反撥	反発
はんぱく	半泊	斑白
はんばつ	藩閥
はんばく	反駁	反ばく
はんばい	販売	半杯
はんはん	半々
はんのう	反応	半農	半納	半能	飯能
はんねん	半年
はんにん	犯人	半人
はんにゃ	般若
はんにち	半日	反日
はんにえ	半煮え
はんなん	阪南
はんなま	半生
はんなき	半泣き
はんなが	半長
はんどん	半ドン
はんどく	判読	繙読
はんどう	半藤	反動	般道	半道
はんとし	半年
はんとき	半時	半刻
はんとう	半島	反騰
はんてん	斑点	飯店	反転	半纏	半天	反轉
はんてつ	半徹
はんてい	判定	藩邸
はんづら	版面
はんつき	半月
はんちか	半地下
はんだん	判断
はんだづ	半田付
はんだず	半田付
はんだい	飯台	阪大	大阪大学	版代
はんたま	半玉
はんたい	反対
はんぞく	反俗
はんぞう	半蔵	楾
はんそで	半袖
はんそく	反則	犯則	半束	反側	販促
はんそう	半荘	搬送	帆走
はんぜん	判然
はんせん	半銭	反戦	帆船
はんせつ	半切	反切
はんせき	犯跡	版籍
はんせい	反省	半生	藩政	繁生
はんすう	反芻	半数	版数
はんすい	半睡
はんじん	半人
はんじゃ	判者
はんじほ	判事補
はんじつ	半日	反実
はんしん	半身	半神	叛臣	版心	阪神
はんしゅ	藩主
はんしゃ	反射	販社
はんしつ	半室
はんした	版下
はんしき	範式	版式
はんざん	飯山
はんざわ	半澤	半沢
はんざつ	繁雑	煩雑
はんざい	犯罪
はんさつ	藩札
はんさく	半作
はんさき	飯崎
はんさい	半済	半裁	燔祭	半歳
はんごん	反魂
はんごろ	半殺
はんごう	半合	飯盒
はんこん	瘢痕
はんこつ	反骨
はんこう	藩侯	反攻	犯行	反抗	藩校
はんげん	半減	半舷	半源
はんげつ	半月
はんげき	反撃	繁劇
はんけん	版権	半研	半券
はんけつ	判決
はんけい	判型	半径
はんぐん	反軍	叛軍	半群
はんくら	半クラ
はんぎれ	半切れ
はんぎり	半切り
はんぎょ	半漁
はんきん	半金
はんきれ	半切れ
はんがん	半眼	判官
はんがた	判型	版型	判形
はんがそ	半画素
はんがく	藩学	半額
はんがか	版画家	版画化
はんかん	半環	繁簡	反間	繁閑	反感
はんかた	汎型
はんかこ	半過去
はんかく	半角	反核
はんかい	半解	半開	半壊	半潰
はんおん	半音
はんおし	半押
はんえん	半円
はんえり	半襟
はんえい	繁栄	反映	半影
はんいん	班員
はんいご	反意語
はんあい	汎愛
はわたり	刃渡り
はれんち	破廉恥
はれわた	晴れ渡
はれやま	晴山
はれもの	腫物
はればれ	晴れ晴れ	晴々
はるよし	晴芳
はるゆき	治幸	治之	春幸	晴幸	陽之
はるやま	春山
はるやす	春休	晴康	陽保
はるもの	春物
はるみつ	晴光
はるまき	春巻
はるふじ	春藤
はるびん	哈爾浜
はるひろ	晴弘
はるひと	治人
はるひで	治秀
はるひさ	晴久	陽久	治久	春久
はるひこ	晴彦	晴比古	春彦	治彦
はるばる	遥々
はるなつ	春夏
はるぞら	春空
はるさめ	春雨
はるさく	春作
はるさき	春先
はるごろ	春頃
はるごう	春号
はるぐち	春口
はるきち	春吉
はるかわ	春川
はるかぜ	春風
はるおみ	晴臣
はるおか	春岡
はるあき	春秋
はりわた	張り渡
はりやま	張山	針山
はりもと	張本	播本
はりめぐ	張り巡
はりみち	針道
はりまや	針間矢	播磨屋
はりぼて	張りぼて
はりふだ	貼り札	張札	はり札	張り札
はりばこ	針箱
はりぬい	針縫
はりつけ	貼付	張り付け	磔	貼り付け
はりさし	針刺し
はりさき	針先
はりこみ	張り込み	貼り込み
はりけん	破裏拳
はりぐち	播口
はりがや	針ヶ谷	針谷
はりがみ	貼紙	はり紙	張り紙	張紙	貼り紙
はりがね	針金
はりがた	張り形	張型	張形	張り型
はりかた	張り形	張型	張形	張り型
はりかえ	張替
はりうお	針魚
はりいち	針位置
はりいた	張板
はりあわ	貼り合
はりあみ	張網	張り網
はりあな	針穴
はりあい	張り合い	張合い
はらわた	腑	腸
はらよし	原良
はらやま	原山
はらもち	腹持ち
はらみつ	波羅蜜
はらみず	原水
はらまち	原町
はらまき	腹巻
はらぺこ	腹ぺこ
はらびれ	腹鰭
はらばい	腹這い
はらのや	原野谷
はらなか	原中
はらっぱ	原っぱ
はらちが	腹違
はらだつ	腹立つ
はらだち	腹立ち
はらたけ	原茸
はらじま	原島
はらしま	原嶋	原島
はらさわ	原沢	原澤
はらさき	原崎
はらこし	原越
はらげい	腹芸
はらぐろ	腹黒
はらぐち	原口
はらきり	腹切り
はらがま	腹構
はらかわ	原川
はらから	同胞
はらおび	腹帯
はらおか	原岡
はらいの	払い除
はらいだ	払出
はらいた	腹痛
はらいせ	腹癒せ	腹いせ
はらいさ	払い下
はらいこ	払い込	払込
はらあて	腹当
はやわり	早割
はやわざ	早技	早業
はやりた	逸り立
はやめし	早飯
はやみや	早宮
はやみみ	早耳
はやみち	早道
はやみず	速水	早水
はやまき	早蒔き
はやべん	早弁
はやぶさ	隼	鶻
はやふじ	早藤
はやびき	速弾き
はやひと	隼人
はやばん	早番	早版
はやばや	早々
はやとき	早解き
はやだち	早立ち
はやだし	早出し
はやじに	早死
はやしや	林屋	林家
はやしま	早島
はやしば	林葉
はやしだ	林田
はやした	早下	囃し立
はやしお	早潮
はやざし	早指し
はやざき	早咲き
はやさか	早坂
はやぐい	早喰い	早食い
はやくち	早口
はやくさ	早草
はやきた	早来
はやがわ	早変
はやがね	早鐘
はやがけ	早駆け
はやがえ	早帰
はやかわ	早川
はやおし	早押し
はやおく	早送
はやおき	早起き
はやうま	早馬
はやうち	早打ち	速打ち	早撃ち
はやうた	早歌
はやあし	速足	早足
はめこみ	嵌め込み
はめいた	羽目板
はみがき	歯磨き	歯磨
はまゆう	浜木綿
はまやす	浜靖
はまやき	浜焼
はまもと	濱本	浜元
はまめし	浜飯
はまむら	浜村
はまみち	浜道
はままで	浜迄
はままつ	浜松
はまます	浜益
はまびと	浜人
はまなす	浜茄子
はまなこ	浜名湖
はまなか	濱中	浜中
はまつか	濱塚
はまっこ	浜っ子
はまちか	浜近
はまたけ	浜竹
はまじま	浜島
はましま	濱島
はましぎ	浜鷸
はまざき	浜崎
はまさき	浜崎	濱崎
はまさか	浜坂
はまぐり	蛤
はまぐち	浜口
はまきた	浜北
はまがわ	浜側
はまがみ	濱上	浜上
はまかわ	濱川	浜川
はまかど	濱角
はまかつ	浜勝
はまかた	浜方
はまかぜ	浜風
はまおぎ	浜荻
はまおか	浜岡
はまいで	浜出
はぼまい	歯舞
はぼたん	葉牡丹
はぶらし	歯ブラシ
はぶたえ	羽二重
はびきの	羽曳野
はばよせ	幅寄せ
はばひろ	幅広	巾広
はばとび	幅跳	幅跳び
はばきき	幅利き
はばかる	憚る
はばうえ	巾上
ははびと	母人
ははのひ	母の日
ははねこ	母猫
ははじま	母島
ははぎみ	母君
ははきぎ	帚木
ははかた	母方
ははおや	母親
ははうえ	母上
ははいぬ	母犬
はのうら	羽ノ浦
はねもの	羽根物	羽物
はねむし	羽虫
はねまわ	跳ね回
はねばし	跳ね橋
はねごし	跳ね腰
はねかえ	跳ね返
はねおか	羽丘
はねいし	羽石
はにわり	半月
はにゅう	羽生	埴生
はにしな	埴科
はにおか	埴岡
はにうだ	羽生田
はなれや	離れ家
はならび	歯並び
はなよめ	花嫁
はなやま	花山
はなやぎ	花柳
はなもり	花森
はなもの	花物
はなもと	花本
はなもじ	花文字
はなむら	花村
はなむこ	花婿
はなむけ	贐	餞
はなみね	鼻梁
はなみち	花道
はなみぞ	鼻溝
はなみず	花水	鼻水	洟
はなみく	花見区
はなまる	花丸
はなまち	花街
はなまき	花巻
はなぶさ	萼	蕚	英	花房
はなぶえ	鼻笛
はなふだ	花札
はなふさ	花房
はなびら	花弁	花びら
はなびや	花火屋
はなびし	花火師	花菱
はなびえ	花冷え	花冷
はなひら	花開
はなばな	花々	華華	華々
はなはだ	甚	甚だ
はなはた	花畑
はなはく	花博
はなのき	花の木
はなにら	花韮
はなどき	花時
はなてん	放出
はなづら	鼻面
はなづな	鼻綱	花綵
はなつま	鼻抓
はなだい	花代
はなたれ	洟垂れ
はなたば	花束
はなたに	花谷
はなたか	花高
はなぞめ	花染
はなぞの	花園	華園
はなずら	鼻面
はなすじ	鼻梁	鼻筋
はなじる	洟
はなしま	花島
はなして	話し手
はなしだ	話し出	話出
はなしず	話好
はなしこ	話し込
はなしが	放し飼
はなしか	話し掛	噺家
はなしあ	話し合
はなざわ	花沢
はなざけ	花酒
はなざか	花盛
はなさき	花咲	鼻先
はなさか	花阪
はなごえ	鼻声
はなぐも	花曇
はなぐみ	花組
はなくま	花隈
はなくそ	鼻屎	鼻糞	鼻クソ	鼻くそ
はなぎれ	花布
はなきん	花金
はながら	花柄
はながめ	花瓶
はながみ	鼻紙
はながた	花形	花型	鼻型
はながさ	花笠
はながき	花垣
はなかぜ	鼻風邪	鼻カゼ
はなかご	花籠
はなおか	花岡	華岡
はなうり	花売り
はなうた	鼻唄	鼻歌
はないろ	花色
はないき	鼻息
はどうば	波動場
はとりべ	服部
はとやま	鳩山
はともと	波戸元
はとむね	鳩胸
はとむぎ	鳩麦
はとがや	鳩谷	鳩ヶ谷
はてしな	果てし無
はつわじ	発話時
はつれい	発令
はつらん	撥乱
はつらつ	溌剌
はつよう	発揚
はつゆめ	初夢
はつゆき	初雪
はつやま	初山
はつもん	発問
はつもの	初物
はつもう	発毛
はつめい	発明
はつみみ	初耳
はつまご	初孫
はつぼん	初盆
はつほん	発本
はつふゆ	初冬
はつふじ	初富士
はつばい	発売
はつはる	初春
はつはな	初花
はつねつ	発熱	發熱
はつなつ	初夏
はつどう	発動
はつとみ	初富
はつでん	発電
はつづり	初釣
はつづき	初月
はつつき	初月
はつだい	初台
はつたけ	初茸
はつぜみ	初蝉
はつせき	初席
はつずり	初刷
はつすべ	初滑
はつじも	初霜
はつしん	発進
はつしも	初霜
はつしま	初島
はつしば	初芝
はつざん	初産
はつさわ	初沢
はつこい	初恋
はつげん	撥弦	発源	発現	発言
はつがん	発ガン	発がん	発癌
はつがり	初狩
はつがお	初顔
はつがい	初買い
はつかん	発艦
はつかり	初雁
はつかぜ	初風
はつおん	撥音	発音
はつえん	発煙
はつえき	発駅
はつうり	初売り	初売
はつうま	初午
はついし	初石
はついく	発育
はつあん	発案
はっぽう	発疱	発砲	八方	発泡
はっぺい	八平
はっぷん	発奮	発憤
はっぴき	八匹
はっぱく	八白
はっとり	服部
はっとう	八東
はってん	発展
はったん	発端	八丹	八反
はったつ	発達
はっそく	発足
はっそう	八相	八双	発送	発想	発走
はっせん	八仙	八千
はっせき	発赤
はっせい	発生	八世	発声
はっすい	撥水
はっしん	発震	発振	発信	発進	発疹	八神
はっしゃ	発車	発射
はっさん	発散
はっさむ	発寒
はっさく	八朔
はっさい	八歳
はっこつ	白骨
はっこう	醗酵	白光	発向	発行	発酵	発効	八講	発航	八紘	発光	薄幸
はっけん	発見	白鍵	発券
はっけみ	八卦見
はっけい	八景	発勁
はっくつ	発掘
はっきん	Pt	発禁	Platinum	白金
はっかん	発汗	発艦	発刊
はっかゆ	薄荷油
はっかち	発火値
はっかけ	八掛
はっかく	八角	発覚
はっかい	発会	八戒
はちろう	八郎
はちょう	波長	ハ調
はちゅう	爬虫
はちもり	八森
はちもの	鉢物
はちめん	八面
はちみつ	蜂蜜
はちまん	八万	八幡
はちまき	鉢巻き	鉢巻
はちまい	八枚
はちぼく	八木
はちほん	八本
はちべえ	八兵衛
はちばん	八番
はちのへ	八戸
はちのす	蜂の巣
はちのじ	八の字
はちのこ	蜂の子
はちねん	八年
はちにん	八人
はちすか	蜂須賀
はちこう	ハチ公
はちけん	八軒
はちがつ	八月	葉月	8月
はちかい	八開
はちうえ	鉢植	鉢植え
はだつけ	肌付け
はだざわ	肌触
はだざむ	肌寒
はださむ	肌寒
はだかび	裸火
はだかけ	肌掛け
はだいろ	肌色
はだあれ	肌荒	肌あれ
はだあい	肌合	肌合い
はたらき	働き
はたやま	畑山	畠山
はたもと	旗本	播本	畑本
はたもち	旗持
はたむら	畑村
はたふり	旗振り
はたはた	鰰
はたのし	秦野市
はたのう	畑農
はたなか	畠中	畑中	畑仲
はたとせ	二十歳
はたたて	旗立
はたして	果して
はたざき	畑崎
はたざお	旗竿
はたさく	畑作
はたごや	旅籠屋
はたぐも	旗雲
はたきこ	叩き込
はたがや	幡ヶ谷
はたおり	旗折	機織	機織り
はたおか	畑岡
はたうえ	畑上
はたいろ	旗色
はたいけ	幡池
はたあげ	旗揚	旗揚げ
はせんぶ	波線部
はせさん	馳せ参
はせくら	支倉
はせがわ	長谷川
はせいご	派生語
はずかし	辱
はすむか	斜向
はすぬま	蓮沼
はすっぱ	蓮葉	蓮っ葉
はすいけ	蓮池
はじらい	羞じらい
はじょう	波状
はじめね	始値	始め値
はじめて	初めて
はじまり	始まり
はじとみ	半蔀
はじきと	弾き飛
はじきだ	弾き出
はじかみ	薑
はじいろ	黄櫨色
はしわた	橋渡
はしりゆ	走り湯
はしりぬ	走り抜
はしりで	走り出
はしりだ	走り出
はしりす	走り過
はしりさ	走り去
はしりこ	走り込
はしりが	走り書
はしりい	走井
はしゅつ	派出
はしもり	橋守
はしもと	橋本
はしひめ	橋姫
はしばみ	榛
はしばし	端々
はしづめ	橋爪	橋詰
はしっこ	端っこ
はしだて	橋立
はしため	端女	婢女	端た女	婢
はしたに	橋谷
はしたか	鷂
はしぞめ	箸初め
はしずめ	橋爪
はしげた	橋桁	橋げた
はしぐち	橋口
はしくれ	端くれ
はしくら	橋倉
はしがみ	橋上
はしがき	端書	端書き
はしかわ	橋川
はしかみ	階上
はしおき	箸置き
はしおか	橋岡
はしうら	橋浦
はしいた	橋板
はざわり	歯触り
はざくら	葉桜
はざかい	端境
はさみこ	挟み込
はさみう	挟み撃
はごろも	羽衣
はごたえ	歯応え
はごいた	羽子板
はこもり	箱守
はこもの	箱物
はこまつ	筥松
はこぼれ	刃毀れ
はこぶね	箱船	箱舟	方舟
はこびだ	運び出
はこびこ	運び込
はこねじ	箱根路
はこにわ	箱庭
はこづめ	箱詰め	箱詰
はこづけ	箱付
はこだて	函館
はこした	箱下
はこざき	箱崎	筥崎
はこがた	箱型
はこがき	箱書	箱書き
はこいり	箱入り	箱入
はげわし	禿鷲
はげやま	禿山
はげたか	禿鷹
はけぐち	捌け口	はけ口
はぐるま	歯車
はくろん	博論
はくろう	白蝋	伯労
はくりき	薄力
はくらん	白藍	博覧
はくらく	剥落	白楽	伯楽
はくらい	舶来
はくよう	伯洋	白楊
はくゆん	学胤
はくめん	白面
はくめい	薄命	薄明
はくまく	薄膜	白膜
はくまい	白米
はくぼく	白墨
はくほう	白鳳
はくへん	薄片	剥片
はくへき	白壁
はくへい	白兵
はくぶん	白文	博聞	博文
はくぶつ	博物
はくばん	薄板	白板
はくばい	白梅
はくはん	白斑	白飯
はくはつ	白髪
はくはく	白々
はくねつ	白熱
はくどう	白銅	搏動	拍動	白道
はくとう	白頭	白糖	白桃	白湯
はくてん	白点
はくてい	白丁
はくつる	白鶴
はくちび	白痴美
はくちず	白地図
はくだん	白檀
はくだつ	はく奪	剥奪	剥脱
はくだく	白濁
はくたん	白炭
はくそう	博捜
はくぜん	白髯
はくせん	白癬	白線
はくせつ	白雪
はくせき	白皙	白石
はくせい	剥製
はくすう	拍数	搏数	泊数
はくすい	白水
はくじん	白人	白刃
はくじゅ	白寿
はくじゃ	白蛇
はくじつ	白日
はくしん	迫真	白新
はくしょ	帛書	薄暑	白書
はくしゅ	拍手
はくしゃ	薄謝	拍車	白砂
はくしま	白島
はくしつ	白質
はくしき	博識
はくさん	白山
はくさい	白菜	舶載
はくげき	迫撃	搏撃
はくげい	白鯨
はくぐう	薄遇
はくぎん	白銀
はくがん	白眼
はくがく	博学
はくがい	迫害
はくかい	擘開
はくおし	箔押し
はくおう	白鴬	白鴎
はくえん	白煙
はくえい	搏景
はくうん	白雲
はくあき	白堊紀	白亜期	白亜紀
はくあい	博愛
はぎわら	萩原
はぎょう	ハ行	は行	覇業
はぎもり	萩森
はぎもと	萩本
はぎひら	萩平
はぎはら	萩原
はぎたに	萩谷
はぎしり	歯軋り
はぎあわ	接ぎ合
はきょく	破局
はきょう	破鏡
はきゅう	波及
はきゃく	破却
はきもの	履物
はきちが	履き違
はきだめ	掃き溜め
はきだし	掃き出し	掃出し
はがため	歯固め
はがぐん	芳賀郡
はがくれ	葉隠れ	葉隠
はかりめ	秤目
はかりし	計り知
はかりか	計り兼
はかりう	量り売
はからう	計らう
はからい	計らい
はかもり	墓守
はかむら	墓村
はかまだ	袴田
はかまい	墓参
はかばか	捗々
はかたく	博多区
はかしょ	墓所
はかくね	破格値
はかいど	破壊度
はかいし	墓石	破壊子
はかいご	破壊後
はかあな	墓穴
はえばる	南風原
はえぬき	生え抜き
はえなわ	延縄
はえとり	蝿取り
はえぎわ	生え際
はえかわ	生え変
はいろん	俳論
はいれつ	配列	排列
はいれい	拝礼
はいりょ	配慮
はいりつ	廃立
はいりこ	入り込
はいらん	排卵
はいらる	海拉爾
はいよう	胚葉	廃用	肺葉	佩用
はいゆう	俳優	俳友
はいやく	配役	背約
はいもん	肺門
はいめん	背面
はいめつ	廃滅
はいめい	俳名	拝命
はいまわ	這い回
はいまつ	這松
はいぼく	敗北
はいぼう	敗亡
はいほん	配本
はいほう	敗報	肺胞
はいべん	排便
はいへい	敗兵
はいぶん	配分	拝聞	俳文
はいぶつ	廃物
はいふん	—	‐
はいふじ	配布時
はいふく	拝復
はいふき	灰吹
はいふう	誹風	俳風
はいびん	配便
はいひん	廢品	廃品
はいぱい	配牌
はいばん	廃番	廃版	廃盤	杯盤
はいばら	榛原	生原
はいはん	背叛	悖反	背反	廃藩	排反
はいはい	這い這い
はいのう	胚嚢	排膿	背嚢
はいねつ	排熱	廃熱
はいねこ	灰猫
はいにん	背任
はいにち	排日
はいどく	拝読
はいどう	廃道
はいとく	悖徳	背徳
はいとう	配当	佩刀
はいでん	配電	拝殿
はいてん	配点	配転
はいてい	拝呈	廃帝
はいちず	配置図
はいちご	配置後
はいちが	配置換
はいだん	俳壇
はいたつ	配達
はいたか	鷂
はいたい	廃退	敗退	佩帯	廃頽	胚胎
はいぞく	配属
はいぞう	肺臓
はいそん	廃村
はいそく	背足	背側
はいそう	背走	配送	敗走
はいぜん	沛然	配膳
はいぜつ	廃絶
はいせん	廃線	敗線	敗戦	配船	肺尖	廃船	配線
はいせつ	排泄	排雪
はいせき	排斥
はいせい	敗勢	廃星	俳聖
はいすい	廃水	背水	排水	配水
はいじん	廃人	配陣	癈人	拝塵	俳人
はいじょ	排除	廃除
はいじゅ	拝受
はいじま	拝島
はいじく	胚軸
はいしん	配信	背信	背進
はいしょ	俳書	配所
はいしゅ	胚珠
はいしゃ	廃車	拝謝	歯医者	敗者	配車
はいしび	廃止日
はいしつ	肺疾	廃疾	癈疾
はいしご	廃止後
はいざん	廃山	敗残	廃残
はいざら	灰皿
はいざい	配剤	廃材
はいさつ	拝察	廃札
はいごう	配合	俳号	廃合
はいこう	配向	配光	廃校	廃鉱	廃坑
はいげき	排撃
はいけん	佩剣	拝見
はいけい	拝啓	背景	拝敬
はいぐん	敗軍
はいぐう	配偶
はいぎょ	肺魚
はいきん	拝金	背筋
はいきょ	廃墟	廃虚
はいがん	拝顔	肺癌	肺ガン
はいがゆ	胚芽油
はいがた	灰型
はいがす	排ガス
はいがく	廃学
はいがい	拝外	排外
はいかん	廃艦	廃刊	廃官	拝観	配管
はいかい	徘徊	誹諧	俳諧
はいおく	廃屋
はいえん	肺炎	排煙
はいえつ	拝謁
はいえき	廃駅	廃液
はいえい	背泳
はいいん	排印	敗因	配員
はいいろ	灰色
はいあん	廃案
ほんろせん	本路線
ほんるいだ	本塁打
ほんりょう	本領
ほんりゅう	奔流	本流
ほんよさん	本予算
ほんやめい	本屋名
ほんやくじ	翻訳時
ほんやくき	翻訳機
ほんやくか	翻訳化	翻訳家
ほんやがい	本屋街
ほんめいば	本命馬
ほんめいし	本命視
ほんみょう	本名
ほんまつり	本祭	本祭り
ほんぶない	本部内
ほんぶたい	本舞台
ほんぶせき	本部席
ほんぶしん	本普請
ほんぴょう	本表
ほんばもの	本場物
ほんばしょ	本場所
ほんのまち	本の街
ほんのうじ	本能寺
ほんねんど	本年度
ほんなだい	本名題
ほんどせん	本土線
ほんどおり	本通り
ほんどうし	本動詞
ほんちょう	本庁	本朝	本町
ほんちゅう	本中	奔注
ほんちゅー	紅中
ほんそうち	本装置
ほんせきち	本籍地
ほんじょう	本条	本匠	本状	本城	本荘	本庄
ほんじたい	本自体
ほんじしょ	本辞書
ほんしんさ	本審査
ほんしよう	本仕様
ほんしょく	本職	本色
ほんしょう	本症	本章	本性	本賞	本証	本省	本荘
ほんしゅつ	奔出	本出
ほんしゅう	本州
ほんしこう	本施行
ほんしけん	本試験
ほんこうざ	本講座
ほんぐもり	本曇り
ほんぎょう	本業	本行
ほんぎまり	本決まり
ほんきょち	本拠地
ほんきょく	本局
ほんきゅう	本給
ほんきてい	本規定
ほんきそく	本規則
ほんきじる	本気汁
ほんきしゅ	本機種
ほんきかく	本企画
ほんがんじ	本願寺
ほんがかり	本係
ほんかわね	本川根
ほんかどり	本歌取り
ほんかせい	本科生
ほんかくは	本格派
ほんかくか	本格化
ほんかいぎ	本会議
ほんいでん	本位田
ほんいせい	本位制
ほんいがい	本以外
ほんあつぎ	本厚木
ほろばしゃ	幌馬車
ほろかない	幌加内
ほろいずみ	幌泉
ほれぐすり	惚れ薬
ほれいよう	保冷用
ほれいざい	保冷材
ほるみうむ	Ho	Holmium
ほりものし	彫物師
ほりのくち	堀之口
ほりのうち	堀の内	堀之内
ほりたつお	堀辰雄
ほようじょ	保養所
ほようしょ	保養所
ほゆうぜい	保有税
ほゆうすう	保有数
ほゆうしゃ	保有者
ほゆうこく	保有国
ほやがらす	保谷硝子
ほめごろし	誉め殺し
ほめことば	褒め言葉
ほまれおお	誉大
ほねやすめ	骨休め
ほねやすみ	骨休み
ほねっぷし	骨っ節
ほねざかな	骨魚
ほねおしみ	骨惜しみ
ほどがやく	保土ヶ谷区
ほどうれき	補導歴
ほどうがわ	歩道側
ほととぎす	不如帰	杜鵑	子規	蜀魂	時鳥
ほとけのざ	仏の座
ほとけさま	仏様
ほづきょう	保津峡
ほっぽりだ	ほっぽり出
ほっそくじ	発足時
ほっさてき	発作的
ほっきょく	北極
ほっきにん	発起人
ほっきしゃ	発起者
ほっきがい	北寄貝
ほちょうき	補聴器
ほたるぞく	蛍族
ほたるがわ	蛍川
ほたるがり	蛍狩
ほたるいし	蛍石
ほたるいか	蛍烏賊
ほたてがい	帆立貝
ほぞんよう	保存用
ほぞんほう	保存法
ほぞんばん	保存版
ほぞんてき	保存的
ほぞんそく	保存則
ほぞんせい	保存性
ほぞんしゃ	保存車
ほぞくてき	保続的
ほそづくり	細作り
ほそくてき	補足的
ほそくざい	捕捉剤
ほそおもて	細面
ほそうどう	舗装道
ほせいよう	補正用
ほせいこう	補正項
ほせいいた	補正板
ほすとこく	ホスト国
ほすうけい	歩数計
ほじりょく	保持力	保磁力
ほじょりん	補助輪
ほじょよく	補助翼
ほじょよう	補助用
ほじょとう	補助灯
ほじょてき	補助的
ほじょせん	補助線
ほじょせき	補助席
ほじょざい	補助剤
ほじょこう	補助光
ほじょけん	補助券	補助犬
ほじょきん	補助金
ほじょいん	補助員
ほしょうち	保証値
ほしゅよう	保守用
ほしゅとう	保守党
ほしゅてき	保守的
ほしゅせい	保守性
ほしゅけい	保守系
ほしゅうひ	補修費
ほしゅいん	保守員
ほしまつり	星祭り	星祭
ほしぶどう	干し葡萄	乾し葡萄
ほしのかず	星の数
ほしづきよ	星月夜
ほしつざい	保湿剤
ほしつえき	保湿液
ほしじるし	星印
ほしがれい	干し鰈	星鰈
ほしがおか	星ヶ丘
ほしうらな	星占
ほしいまま	擅	恣
ほしあかり	星明り
ほごはんい	保護範囲
ほごでんち	保護電池
ほごちょう	保護鳥
ほごたんい	保護単位
ほごせつび	保護設備
ほごしょく	保護色
ほごしゅぎ	保護主義
ほごしせつ	保護施設
ほごきのう	保護機能
ほごきてい	保護規定
ほごきこう	保護機構
ほごきかん	保護期間
ほごかのう	保護可能
ほごかいろ	保護回路
ほごあずか	保護預
ほこうしゃ	歩行者
ほげいせん	捕鯨船
ほけんやく	保険薬
ほけんだい	保険代
ほけんじょ	保健所	保険所
ほけんしょ	保健所
ほけんしゃ	保険者
ほけんしつ	保健室	保険室
ほけんきん	保険金
ほけんがく	保険額
ほけんがい	保険外
ほけきょう	法華経
ほくりょう	北陵
ほくりゅう	北龍	北竜
ほくりくじ	北陸路
ほくとせい	北斗星
ほくとうみ	北勝海
ほくとうぶ	北東部
ほくちょう	北朝
ほくじょう	北上
ほくしゅう	北州
ほくうかん	補空間
ほきんしゃ	保菌者
ほきゅうち	補給値
ほきゅうじ	補給時
ほかんよう	保管用
ほかんほう	補間法
ほかんてき	補完的
ほかんじょ	保管所
ほかんざい	補完財
ほかふたり	他二人
ほかならぬ	他ならぬ
ほかたすう	他多数
ほかけぶね	帆掛け船
ほおんよう	保温用
ほおんなべ	保温鍋
ほおんせい	保温性
ほおぶくろ	頬袋
ほおかぶり	頬被り
ほうわてん	飽和点
ほうわしき	飽和式
ほうわがた	飽和型
ほうろうき	放浪記
ほうりろん	法理論
ほうりょう	法量	豊漁	方領
ほうりゅう	放流
ほうりゃく	方略	宝暦
ほうりつご	法律語
ほうりつか	法律化	法律家
ほうらけい	和了形
ほうらいじ	鳳来寺
ほうもんび	訪問日
ほうもんじ	訪問時
ほうもんぎ	訪問着
ほうもんき	訪問記
ほうめいぼ	芳名簿
ほうむりさ	葬り去
ほうみょう	法名
ほうぶんか	法文化
ほうふくじ	豊福寺
ほうびょう	宝瓶
ほうねつき	放熱器
ほうにょう	放尿
ほうどうぶ	報道部
ほうでんじ	放電時
ほうでんき	放電器
ほうちょう	訪朝	庖丁	包丁	放鳥
ほうちゅう	庖厨	訪中	包虫
ほうちゃく	逢着	縫着
ほうちしゃ	放置車
ほうちしき	法知識
ほうちこく	法治国
ほうそうぶ	放送部
ほうそうび	放送日
ほうそうは	放送波
ほうそうじ	放送時
ほうそうし	包装紙
ほうせんか	鳳仙花
ほうせきや	宝石屋
ほうせいび	法整備
ほうせいど	法制度
ほうせいし	法制史
ほうせいか	法制化
ほうすいろ	放水路
ほうすいき	豊水期
ほうじんか	法人化
ほうじょう	豊饒	北條	法帖	方丈	豊穣	芳情	北条	豊穰	方城	褒状	宝条	方乗	蓬生
ほうじゅん	豊潤	芳醇
ほうじゅつ	方術	砲術
ほうじゅく	豊熟
ほうじゅう	放銃	放縱	放縦
ほうじちゃ	焙じ茶
ほうしょく	飽食	宝飾	奉職
ほうしょう	奉唱	報賞	法相	報奨	放縦	褒章	褒賞	宝生	宝商	報償
ほうしゅん	芳春
ほうしゅつ	放出	法出
ほうしゅく	奉祝
ほうしゅう	報酬
ほうしゃち	放射値
ほうしゃき	放射器
ほうしゃか	放射化
ほうしひん	奉仕品
ほうしのう	胞子嚢
ほうしたい	胞子体
ほうししゃ	奉仕者
ほうごうご	抱合語
ほうことう	澎湖島
ほうこくき	報告記
ほうこうゆ	芳香油
ほうこうだ	方向舵
ほうこうじ	方広寺
ほうけいは	方形波
ほうぎょく	宝玉
ほうきょう	豊凶	法橋	豊頬	豊胸	奉教
ほうきゅう	俸給
ほうきゃく	訪客
ほうきぼし	ほうき星	箒星	彗星
ほうきはん	法規班
ほうきせい	法規制
ほうきぐさ	箒草
ほうきがみ	箒神
ほうがんし	方眼紙
ほうがてき	胞芽的
ほうがっき	邦楽器
ほうがっか	法学科
ほうがくぶ	法学部
ほうがくか	法学科
ほうかだて	邦貨建
ほうかいず	崩壊図
ほうかいじ	法界寺
ほうおうざ	鳳凰座
ほうえいび	放映日
ほうえいじ	放映時
ほうえいご	放映後
ほういもう	包囲網
ほういせん	包囲戦
ほういけん	放医研
ほういがく	法医学
ほういかく	方位角
ほうあんか	法案化
ほいくじょ	保育所
ほいくしょ	保育所
ほいくしゃ	保育者	保育社
ほいくしつ	保育室
ほいくえん	保育園
ほあんりん	保安林
ほあんよう	保安用
ほあんたい	保安隊
ほあんかん	保安官
へんりょう	変量
へんまもう	偏摩耗
へんびぶん	偏微分
へんのうゆ	片脳油
へんねんし	編年史
へんにゅう	編入
へんどうひ	変動費
へんちょう	変長	偏重	変調
へんちゅう	編注
へんそくひ	変速比
へんそくじ	変速時
へんそくき	変速機
へんそうじ	返送時
へんせんし	変遷史
へんせいふ	変成譜
へんせいき	変声期
へんずつう	偏頭痛
へんじょう	変成	辺上	返上
へんじまち	返事待
へんじくだ	返事下
へんしんじ	返信時	変身時
へんしんご	変身後
へんしょく	変色	偏食
へんしょう	返照
へんしゅう	編輯	編修	編集	偏執
へんしたい	変死体
へんこうび	変更日
へんこうじ	変更時
へんこうし	偏光子
へんこうご	変更後
へんこうか	変更可
へんけんし	偏見視
へんけいご	変形後
へんきょく	偏極	編曲	変局
へんきょう	辺境	偏狭
へんきゅう	返球
へんきゃく	返却
へんきごう	変記号
へんかんぶ	変換部
へんかんち	変換値
へんかんじ	変換時
へんかんし	変換史
へんかんご	返還後	変換後
へんかんき	変換機	変換器
へんかりつ	変化率
へんかぶん	変化分
へんかてん	変化点
へんかせい	変化性
へんかけい	変化形
へんいたん	変異譚
へんいせい	変移性	変位性
へんあつき	変圧器
へらずぐち	減らず口
へやじゅう	部屋中
へぼんしき	ヘボン式
へぶらいご	ヘブライ語
へびいちご	蛇苺
へのかっぱ	屁の河童
へなちょこ	埴猪口
へそまがり	ヘソ曲がり	へそ曲がり	臍曲り	臍曲がり
へぐらじま	舳倉島
へきちゅう	壁中
へきぎょく	碧玉
へいわろん	平和論
へいわとう	平和党
へいわてき	平和的
へいわだい	平和台
へいわじま	平和島
へいれつど	並列度
へいれつき	並列機
へいれつか	並列化
へいりょく	兵力
へいりゃく	兵略
へいめんは	平面波
へいめんど	平面度
へいめんず	平面図
へいみゃく	平脈
へいばんか	平板化
へいばよう	兵馬俑
へいてんじ	閉店時
へいちょう	兵長	閉庁	敝腸
へいたんち	平坦地
へいたんか	平坦化
へいせかい	閉世界
へいじょう	平常	平壌	閉場	平城
へいじゅん	平準
へいじゅつ	兵術
へいしゅつ	平出
へいしゅう	弊習
へいしたち	兵士達
へいさてき	閉鎖的
へいさつだ	併殺打
へいさせい	閉鎖性
へいさしき	閉鎖式
へいさけい	閉鎖系
へいこうど	並行度	平行度
へいこうし	平行視
へいこうぎ	平衡木
へいけつじ	併結時
へいけがに	平家蟹
へいくかん	閉区間
へいぎょう	閉業
へいきんば	平均場
へいきんち	平均値
へいきんか	平均化
へいきょく	平曲
へいきゅう	閉球
へいかんご	閉館後
へいかつか	平滑化
へいかしき	閉架式
へいかいろ	閉回路
ふんりゅう	噴流	粉瘤
ふんみょう	分明
ふんみまん	分未満
ふんびょう	分秒
ふんにょう	糞尿
ふんにゅう	粉乳
ふんとうき	奮闘記
ふんづまり	糞詰り	糞詰まり
ふんたんい	分単位
ふんぞうえ	糞掃衣
ふんせんき	奮戦記
ふんじょう	紛擾
ふんしょく	粉飾	扮飾	粉食
ふんしゅつ	噴出
ふんしつじ	紛失時
ふんきゅう	紛糾
ふんきこう	噴気孔
ふんかわん	噴火湾
ふんかこう	噴火口
ふんいきだ	雰囲気出
ふろうりん	不老林
ふろうふし	不老不死
ふろうしゃ	浮浪者
ふろあがり	風呂上がり	風呂あがり
ふれんぞく	不連続
ふるほんや	古本屋
ふるなじみ	古馴染
ふるどけい	古時計
ふるどうぐ	古道具
ふるだぬき	古狸
ふるそうび	フル装備
ふるしょう	古庄
ふるざっし	古雑誌
ふるごおり	古郡
ふるこおり	古郡
ふるくさい	古臭い
ふるぎつね	古狐
ふるぎって	古切手
ふるがっき	古楽器
ふるかわし	古川市
ふるかどう	フル稼働
ふるえごえ	震え声
ふるいおと	篩い落	振るい落	振い落
ふりびしゃ	振り飛車	振飛車
ふりさけみ	振り放け見
ふりこみび	振込日
ふりこみき	振り込み機
ふりこきき	振子機器
ふらんすご	フランス語
ふらのえき	富良野駅
ふようろん	不用論
ふようぶつ	不要物
ふようひん	不用品	不要品
ふようだい	芙容台
ふようせい	不溶性
ふようしゃ	扶養者
ふようぎむ	扶養義務
ふゆやまや	冬山屋
ふゆやすみ	冬休み
ふゆまつり	冬祭	冬祭り
ふゆびより	冬日和
ふゆのじん	冬の陣
ふゆつばき	冬椿
ふゆじたく	冬支度
ふゆじかん	冬時間
ふゆごもり	冬籠り
ふゆこだち	冬木立
ふゆげしき	冬景色
ふゆくいな	冬水鶏
ふゆきとど	不行届
ふゆがこい	冬囲い
ふゆうれい	浮遊霊
ふゆうぶつ	浮遊物
ふゆうそう	富裕層
ふゆうせき	浮遊石
ふゆうかん	浮遊感
ふゆいらい	冬以来
ふゆいがい	冬以外
ふやじょう	不夜城
ふめんもく	不面目
ふめんぼく	不面目
ふめいろう	不明朗
ふめいてん	不明点
ふめいすう	不名数
ふめいしゃ	不明者
ふめいかく	不明確
ふめいかい	不明快	不明解
ふみんぜい	府民税
ふみづくえ	文机
ふみおこな	踏み行
ふまんてん	不満点
ふまんぞく	不満足
ふまんがお	不満顔
ふほうらん	訃報欄
ふほうせい	不法性
ふへんてき	普遍的	不変的
ふへんせい	不変性	不偏性	普遍性
ふへんしき	不変式
ふへいこう	不平衡
ふぶんりつ	不文律
ふぶんめい	不分明
ふぶんほう	不文法
ふひんこう	不品行
ふひつよう	不必要
ふはつだん	不発弾
ふはついく	不発育
ふはいぶつ	腐敗物
ふのうしゃ	不能者
ふのうこう	不能項
ふのあたい	負の値
ふねんぶつ	不燃物
ふねんせい	不燃性
ふにんてい	不認定
ふにんしゃ	赴任者
ふにんさき	赴任先
ふなわたし	船渡し
ふなばしし	船橋市
ふなつきば	船付場	船着場
ふなだいく	船大工
ふないくさ	船軍
ふなあそび	船遊び
ふどうまえ	不動前
ふどうとく	不道徳
ふどうてん	浮動点	不動点
ふどうたい	不動態	不導体
ふどうそう	浮動層
ふどうせい	浮動性
ふどうさん	不動産
ふとりじし	太り肉
ふとっぱら	太腹	太っ腹
ふとっちょ	太っちょ
ふとせんか	太線化
ふところで	懐手
ふとくてい	不特定
ふとくさく	不得策
ふとうめい	不透明
ふとうせい	不当性
ふとうしき	不等式
ふとうごう	＞	不等号	＜
ふとうこう	不登校	不凍港
ふとうがた	不等型
ふとうおう	不倒翁
ふとうえき	不凍液
ふとういつ	不統一
ふではこび	筆運び
ふでづかい	筆遣い
ふでじまん	筆自慢
ふでがしら	筆頭
ふでおろし	筆下ろし
ふてってい	不徹底
ふてきにん	不適任
ふてきとう	不適当
ふてきせつ	不適切
ふてきせい	不適正
ふてきごう	不適合
ふてきかく	不適格
ふてきおう	不適応
ふていほう	不定法
ふていせい	不定性
ふていさい	不体裁
ふていこん	不定根
ふていけい	不定形
ふつりょう	仏領
ふつりあい	不釣合	不釣り合い	不釣合い
ふつぶんか	仏文科
ふつごよみ	仏語読み
ふつごやく	仏語訳
ふつぎょう	払暁
ふつかよい	二日酔い	二日酔	宿酔
ふつかまち	二日町
ふつかかん	二日間	2日間
ふつかいち	二日市
ふつうもり	普通盛り
ふつうほう	普通法
ふつうばん	普通盤
ふつうぜい	普通税
ふつうせき	普通席
ふつうじん	普通人
ふつうしゃ	普通車
ふつうこう	普通校
ふつうがた	普通型
ふっしょく	払拭
ふっこしゅ	復古酒
ふっけんご	福建語
ふっきゅう	復旧	復仇
ふっきせん	復帰戦
ふっきせつ	復帰説
ふっかつじ	復活時
ふっかつご	復活後
ふちんかん	不沈艦
ふちょうわ	不調和
ふちゅうし	府中市
ふちゅうい	不注意
ふちじせん	府知事選
ふちかざり	縁飾り
ふだんつか	普段使
ふだまもり	札守り
ふだのつじ	札の辻
ふたんりつ	負担率
ふたんぞう	負担増
ふたんしゃ	負担者
ふたんげん	負担減
ふたんきん	負担金
ふたんがく	負担額
ふたんかん	負担感
ふたりよう	二人用
ふたりまえ	二人前
ふたりべや	二人部屋	２人部屋
ふたりぶん	二人分
ふたりのり	二人乗
ふたりとも	二人共
ふたりたび	二人旅
ふたりぐみ	二人組
ふたまわり	二回り
ふたばやま	双葉山
ふたばしゃ	双葉社
ふたとおり	二通り	2通り
ふたつわり	二つ割り
ふたつざわ	二ツ沢
ふたつおり	二つ折
ふたせがわ	二瀬川
ふたごよう	双子用
ふたごやま	二子山
ふたごころ	二心
ふたことめ	二言目
ふたおもて	双面
ふたいてん	不退転
ふたいてき	付帯的
ふたいぜい	付帯税
ふたいおう	不対応
ふぞくぶつ	附属物	付属物
ふぞくひん	付属品	附属品
ふぞくてき	付属的
ふぞくしょ	附属書
ふぞくこう	附属校
ふそんざい	不存在
ふそびょう	腐蛆病
ふそくぶん	不足分
ふそくふり	不即不離
ふそくぎみ	不足気味
ふそくがく	不足額
ふそくかん	不足感
ふそうとう	不相当
ふそうしゃ	扶桑社
ふそうおう	不相応
ふせんめい	不鮮明
ふせんぱい	不戦敗
ふせっせい	不摂生
ふせいりつ	不成立
ふせいてき	父性的
ふせいせき	不成績
ふせいじつ	不誠実
ふせいごう	不整合
ふせいこう	不成功
ふせいけい	不整形
ふせいかく	不正確
ふせいかい	不正解
ふずいてき	付随的
ふずいしゃ	付随車
ふじんふく	婦人服
ふじんしゃ	婦人車
ふじんかい	婦人会
ふじよしだ	富士吉田
ふじょうり	不条理
ふじみだい	富士見台
ふじびたい	富士額
ふじばやし	藤林
ふじばかま	藤袴
ふじのもり	藤森
ふじのみや	藤ノ宮	富士宮
ふじでんき	富士電機
ふじっこう	不実行
ふじちゃく	不時着
ふじさわし	藤沢市
ふじきゅう	富士急
ふじがおか	藤ヶ丘	藤が丘
ふじおやま	富士小山
ふじえだし	藤枝市
ふじいでら	藤井寺
ふしんばん	不寝番
ふしんにん	不信任
ふしんてん	不審点
ふしんせつ	不親切
ふしんしゃ	不審者
ふしんがみ	不審紙
ふしんかん	不信感
ふしょぞん	不所存
ふしょくふ	不織布
ふしょくど	腐植土
ふしょうち	不承知
ふしょうじ	不祥事
ふしょうか	不消化
ふしゅつば	不出馬
ふしゅうぎ	不祝儀
ふしみばん	伏見版
ふしみこう	伏見工
ふしまわし	節回し
ふしちょう	不死鳥
ふしじしゃ	不支持者
ふしくれだ	節榑立
ふしかてい	父子家庭
ふしあわせ	不仕合せ	不幸せ
ふざいしゃ	不在者
ふさんせい	不賛成
ふさじょう	ふさ状
ふさいろく	不採録
ふさいよう	不採用
ふさいたく	不採択
ふさいさん	不採算
ふごうほう	不合法
ふごうなし	符号無し
ふごうけい	符号系
ふごうかく	不合格
ふこころえ	不心得
ふこうよう	不効用
ふこうへい	不公平
ふこうせい	不公正
ふこうしん	負更新
ふげんだけ	普賢岳
ふけんぜん	不健全
ふけんせい	父権制
ふけんしき	不見識
ふけんこう	不健康
ふけつかん	不潔感
ふけいせき	父兄席
ふけいせい	父系制
ふけいざい	不敬罪	不経済	賦形剤
ふけいかい	父兄会
ふくわらい	福笑い
ふくろもの	袋物
ふくろみみ	袋耳
ふくろまち	袋町
ふくろばり	袋貼り
ふくろばら	袋原
ふくろはり	袋貼り
ふくろぬい	袋縫い
ふくろとじ	袋とじ	袋綴じ	袋閉じ
ふくろだな	袋棚
ふくろだた	袋叩
ふくろたに	袋谷
ふくろたけ	袋茸
ふくろおり	袋織
ふくろおび	袋帯
ふくろいり	袋入
ふくろあみ	袋網
ふくりょう	伏竜
ふくりゅう	伏流
ふくらはぎ	腓	脹脛
ふくらしこ	膨らし粉
ふくようじ	服用時
ふくようき	複葉機
ふくやまし	福山市
ふくむいん	服務員
ふくみそん	含み損
ふくみごえ	含み声
ふくみえき	含み益
ふくまでん	伏魔殿
ふくべっぷ	福別府
ふくぶくろ	福袋
ふくびこう	副鼻腔
ふくひれい	複比例
ふくのかみ	福の神
ふくとしん	副都心
ふくちょう	復調	副長
ふくちゅう	腹中
ふくちやま	福知山
ふくだいり	復代理
ふくたろう	福太郎
ふくそすう	複素数
ふくそうり	副総理
ふくそうさ	副走査
ふくせんか	複線化
ふくせいし	複製子
ふくせいか	複製可
ふくすうろ	複数路
ふくすうじ	複数持
ふくすうこ	複数個
ふくすうか	複数可
ふくじょし	副助詞
ふくじゅう	服従	複重
ふくじゃく	副尺
ふくじてき	副次的
ふくしょく	復職	副食	服飾
ふくしょう	副将	副章	複勝	副賞	復誦	復唱	復勝
ふくしゅう	復讐	復習	福州
ふくしゃし	複写紙
ふくしゃき	複写機
ふくしまし	福島市
ふくしどう	副指導
ふくしだい	福祉大
ふくしぜい	福祉税
ふくざつど	複雑度
ふくざつす	複雑過
ふくざつさ	複雑さ
ふくざつか	複雑化
ふくざがた	複座型
ふくさよう	副作用
ふくごうご	複合語
ふくごうか	復号化	複合化
ふくけんじ	副検事
ふくぎょう	副業
ふくおかし	福岡市
ふくうりば	服売場
ふくいだい	福井大
ふくいずみ	福泉
ふくいけん	福井県
ふくいえき	福井駅
ふぎょうぎ	不行儀
ふきんとう	不均等
ふきんしん	不謹慎
ふきんしつ	不均質
ふきんこう	不均衡
ふきんいつ	不均一
ふきょうわ	不協和
ふきょうじ	不況時
ふきょうか	不況下
ふきょうい	府教委
ふきゅうど	普及度
ふきゅうき	普及機
ふきまわし	吹き回し
ふきのとう	蕗の薹
ふきながし	吹流し
ふきでもの	吹出物	吹き出物
ふきだまり	吹き溜り
ふきそくか	不規則化
ふきそうじ	拭き掃除
ふきさらし	吹き曝し
ふがいない	腑甲斐無い
ふかんよう	不寛容
ふかんぜん	不完全
ふかりょう	負荷量
ふかみどり	深緑
ふかぶかと	深々と
ふかひてき	不可避的
ふかなせん	深名線
ふかなさけ	深情け
ふかっぱつ	不活発
ふかっせい	不活性
ふかちろん	不可知論
ふかそうち	付加装置
ふかしょり	付加処理
ふかしょう	不可称
ふかくてい	不確定
ふかくだい	不拡大
ふかくじつ	不確実
ふかくさん	不拡散
ふかぎゃく	不可逆
ふかえはま	深江浜
ふかいかん	不快感
ふおんとう	不穏当
ふおうとう	不応答
ふえいせい	不衛生
ふうりょく	風力
ふうりょう	風量
ふうりゅう	風流
ふうゆほう	諷喩法
ふうぶつし	風物詩
ふうふよう	夫婦用
ふうふやく	夫婦役
ふうふない	夫婦内
ふうふとも	夫婦共
ふうふかん	夫婦間
ふうひょう	風評
ふうばいか	風媒花
ふうにゅう	封入
ふうちりん	風致林
ふうちょう	風鳥	風潮
ふうちちく	風致地区
ふうたろう	風太郎
ふうぞくし	風俗史
ふうすいし	風水士	風水師
ふうじこめ	封じ込め
ふうしんき	風信器
ふうしゅう	風習
ふうさぼう	封鎖棒
ふうけいが	風景画
ふうきょう	風教	風狂
ふうがわり	風変り
ふううんじ	風雲児
ふううんき	風雲記
ふいちょう	吹聴
ふぃりぴん	比律賓
ふあんない	不案内
ふあんてい	不安定
ふあんがお	不安顔
ふあんかん	不安感
ひんみゃく	頻脈
ひんぴょう	品評
ひんにゅう	貧乳
ひんどめい	頻度名
ひんどてき	頻度的
ひんじゃく	貧弱
ひんしるい	貧歯類
ひんしょう	貧小
ひんしゅつ	瀕出	頻出
ひんしゅく	顰蹙
ひんしめい	品詞名
ひんしつさ	品質差
ひんしかん	品詞間
ひんきゅう	殯宮	貧窮
ひんきゃく	賓客
ひわだぶき	檜皮葺き
ひわだいろ	檜皮色
ひわそうち	秘話装置
ひわきのう	秘話機能
ひろのみや	浩宮
ひろたまみ	広田まみ
ひろぜがわ	広瀬川
ひろせどお	広瀬通
ひろせがわ	広瀬川
ひろしょう	広商
ひろしまや	広島屋
ひろしまじ	広島路
ひろしまし	広島市
ひろさきし	弘前市
ひろこうじ	広小路
ひろおえき	広尾駅
ひろうしき	披露式
ひろうかん	疲労感
ひろうかい	披露会
ひろうえん	披露宴
ひろいよみ	拾い読み
ひろいもの	拾い物
ひろいぬし	拾い主
ひろいぐい	拾い食い	拾い喰い
ひろいあつ	拾い集
ひろあきら	寛晰
ひれんけつ	非連結
ひれいぼう	非冷房
ひれいてき	比例的
ひれいぜい	比例税
ひるやすみ	昼休み
ひるひなか	昼日中
ひるぜんご	昼前後
ひるさがり	昼下り	昼下がり	昼下
ひるごはん	昼ご飯	昼御飯
ひるいじど	非類似度
ひりょうず	飛竜頭
ひりょうか	肥料化
ひりゅうづ	飛竜頭
ひりつてき	比率的
ひらやだて	平屋建	平屋建て
ひらばやし	平林
ひらばせん	平場戦
ひらてうち	平手打ち
ひらつかし	平塚市
ひらたえき	平田駅
ひらじょう	平城
ひらきふう	開き封
ひらきなお	開き直
ひらかたし	枚方市
ひらおよぎ	平泳ぎ	平泳
ひらいずみ	平泉
ひらいしん	避雷針
ひらあやま	平謝
ひよりざき	日和崎
ひよしえき	日吉駅
ひよこまめ	雛豆
ひようしゃ	被用者
ひょうろん	評論
ひょうろう	兵糧
ひょうりん	評林
ひょうよみ	票読み
ひょうもん	平文
ひょうもく	標目
ひょうめん	表面
ひょうめい	表明
ひょうぼう	標榜
ひょうほん	標本
ひょうほう	兵法
ひょうへん	豹変
ひょうへき	氷壁	表壁
ひょうふう	飄風
ひょうばん	評判
ひょうはく	表白	漂泊	漂白
ひょうのう	氷嚢
ひょうどう	兵頭	兵藤
ひょうとう	表頭
ひょうでん	票田	評伝
ひょうてん	瓢天	氷点	評点
ひょうてき	標的
ひょうてい	標定	評定
ひょうちん	氷枕
ひょうだん	評壇
ひょうだい	標題	表題
ひょうたん	瓢箪	氷炭
ひょうそく	平仄	表側
ひょうそう	表層	表装
ひょうぜん	飄然
ひょうせつ	剽窃	氷雪	評説
ひょうすう	票数
ひょうじゃ	評者
ひょうじぶ	表示部
ひょうじち	表示値
ひょうじじ	表示時
ひょうじき	表示機	表示器
ひょうじか	表示可
ひょうしゃ	評者
ひょうしぬ	拍子抜
ひょうしつ	氷室
ひょうしぎ	拍子木
ひょうしき	表式	標識
ひょうしが	表紙画
ひょうしえ	表紙絵
ひょうざん	氷山
ひょうさつ	表札
ひょうこう	標高
ひょうげん	評言	表現	氷原
ひょうけん	憑肩	憑険
ひょうけつ	票決	氷結	評決	表決
ひょうけい	表敬
ひょうぐみ	表組み
ひょうぎん	兵銀
ひょうきん	標金	剽軽
ひょうきょ	憑拠
ひょうがわ	豹皮
ひょうがき	氷河期
ひょうがい	表外
ひょうかん	慓悍
ひょうかぶ	評価部
ひょうかち	評価値
ひょうかず	評価図
ひょうかご	評価語	評価後
ひょうかき	評価器	評価機	評価期
ひょうかい	氷塊	氷海	氷解
ひょうおん	表音	氷温
ひょういれ	票入
ひょういつ	飄逸
ひゆりかい	比喩理解
ひややっこ	冷奴
ひやけどめ	日焼止め
ひやくてき	飛躍的
ひゃっぽう	百方
ひゃっぴき	百匹
ひゃっぱん	百般
ひゃっぱつ	百発
ひゃっこう	百行
ひゃっけん	百間	百見
ひゃっけい	百景	百計
ひゃっきん	百均
ひゃっかん	百官	百貫
ひゃっかい	百回
ひゃくれつ	百裂
ひゃくらい	百雷
ひゃくやく	百薬
ひゃくもじ	百文字
ひゃくまん	百万
ひゃくまた	百又
ひゃくまい	百枚
ひゃくぶん	百聞	百分
ひゃくばい	百倍
ひゃくねん	百年
ひゃくにん	百人
ひゃくにち	百日
ひゃくだい	百代
ひゃくたけ	百武
ひゃくたい	百態
ひゃくそく	百足
ひゃくせん	百選	百戦	百千
ひゃくげん	百元
ひゃくがい	百害
ひゃくおく	百億
ひゃくえん	百円
ひゃくいち	百一
ひもじょう	紐状
ひもくべつ	費目別
ひめんけん	罷免権
ひめはじめ	姫始め
ひめじかん	姫路間
ひめじえき	姫路駅
ひみつぼん	秘密本
ひみつきち	秘密基地
ひみつかぎ	秘密鍵
ひみつかい	秘密会
ひまんたい	肥満体
ひまんがた	肥満型
ひまつぶし	暇潰し
ひほしょく	被補食
ひほうかん	秘宝館
ひへいそく	非閉塞
ひへいこう	非平衡
ひぶんかつ	非分割
ひふびょう	皮膚病
ひふていち	非不定値	非負定値
ひふそしき	皮膚組織
ひふごうご	非符号語
ひふくりつ	被覆率
ひふくざい	被覆材
ひふくきん	腓腹筋
ひふきだけ	火吹き竹
ひふかがく	皮膚科学
ひびやせん	日比谷線
ひびやえき	日比谷駅
ひびきわた	響き渡
ひひょうじ	非表示
ひひょうし	批評誌
ひひょうき	批評器
ひひょうか	批評家
ひばらむら	桧原村
ひばくしゃ	被爆者	被曝者
ひばいひん	非売品
ひはんてき	批判的
ひはんしゃ	批判者
ひはんきじ	批判記事
ひのみさき	日御崎	日御碕
ひのととり	丁酉
ひのとうし	丁丑
ひのくるま	火の車
ひのえまた	桧枝岐	檜枝岐
ひのえとら	丙寅
ひのえたつ	丙辰
ひのえさる	丙申
ひのえうま	丙午
ひのえいぬ	丙戌
ひねりつぶ	捻り潰
ひねこびる	陳こびる
ひにんほう	避妊法
ひにんげん	非人間
ひにんけん	否認権
ひにょうき	泌尿器
ひにほんご	非日本語
ひにくきじ	皮肉記事
ひなんみん	避難民
ひなんじょ	避難所
ひなんさき	避難先
ひなんごや	避難小屋
ひなんきじ	非難記事
ひなまつり	雛祭	雛祭り	ひな祭り
ひないどり	比内鶏
ひなあられ	雛霰
ひなあそび	雛遊び
ひどのらか	Hydnoraceae	ヒドノラ科
ひどうさじ	非動作時
ひとりよう	一人用
ひとりもの	独り者
ひとりまえ	一人前
ひとりべや	一人部屋
ひとりぶん	一人分
ひとりのり	一人乗り
ひとりっこ	一人っ子
ひとりだち	独り立ち	一人立
ひとりたび	一人旅
ひとりじめ	一人占め	独り占め
ひとりごと	一人言	独り言
ひとりぐち	一人口
ひとりがち	一人勝ち	独り勝ち
ひとりうち	一人打ち
ひとりうき	一人浮き
ひとりある	一人歩
ひとよたけ	一夜茸
ひとよぎり	一節切
ひとやすみ	一休み
ひともなげ	人も無げ
ひともうけ	一儲け
ひとめぼれ	一目惚れ
ひとむかし	一昔
ひとみしり	人見知り
ひとまわり	一回り
ひとまかせ	人任せ
ひとべらし	人減らし
ひとぶそく	人不足
ひとふでが	一筆書
ひとふくろ	一袋
ひとひねり	一ひねり	一捻り
ひとひとり	人一人
ひとぱっく	一パック
ひとばんご	一晩後
ひとばらい	人払い
ひとばしら	人柱
ひとはらん	一波乱
ひとはたら	一働
ひとはしり	一走り
ひとねむり	一眠り
ひとねいり	一寝入り
ひとにぎり	一握り
ひとなかせ	人泣かせ
ひとどおり	人通り
ひとどうし	人同志	人同士
ひととなり	為人
ひととおり	一通り
ひとていど	人程度
ひとづきあ	人付き合
ひとづかれ	人疲れ
ひとづかい	人使い
ひとつまみ	一摘み	一撮み
ひとつまつ	一松
ひとつぼし	一つ星
ひとつばし	一橋	一ッ橋	一ツ橋
ひとつかま	一つ釜
ひとっとび	ひとっ飛び
ひとちがい	人違い
ひとだまり	人溜り
ひとだのみ	人頼み
ひとだすけ	人助け
ひとだかり	人集り
ひとたまり	一溜り
ひとせだい	一世代
ひとじたい	人自体
ひとじしん	人自身
ひとしれず	人知れず
ひとしばい	一芝居
ひとしなみ	等し並み
ひとしだい	人次第
ひとしごと	一仕事
ひとさらい	人攫い
ひとさがし	人探し
ひとごろし	人殺し
ひとごころ	人心
ひとごこち	人心地
ひとこじん	人個人
ひとけため	1桁目
ひとくろう	一苦労
ひとくふう	一工夫
ひとくちめ	一口目
ひとくだり	一行
ひとくせい	秘匿性
ひとくくり	一括り
ひとくぎり	一区切り
ひとぎらい	人嫌い
ひとがんば	一頑張
ひとからげ	一絡
ひとかぞく	一家族
ひとかせぎ	一稼ぎ
ひとかすみ	一霞
ひとかかえ	一抱え
ひとえもの	単物
ひとえぐさ	一重草
ひといきれ	人いきれ
ひといがい	人以外
ひとあつめ	人集め
ひとあたり	人当り
ひとあいて	人相手
ひでんしゃ	被伝者
ひでんかく	非電化区
ひでんいん	悲田院
ひてつづき	非手続き
ひてきごう	非適合
ひていろん	否定論
ひていぶん	否定文
ひていてき	否定的
ひづけいん	日付印
ひつりょく	筆力
ひつような	必要な
ひつようど	必要度
ひつにょう	泌尿
ひつぜんか	必然化
ひつじょう	必定
ひつじゅん	筆順
ひつじゅつ	筆述
ひつじどし	未年
ひつじさる	坤
ひつじぐも	羊雲
ひつじかい	羊飼い
ひつけやく	火付け役
ひっぱりだ	引っぱり出
ひっぱりこ	引っ張り込
ひっとすう	ヒット数
ひっとさく	ヒット作
ひっちょう	必聴
ひっちゅう	筆誅	必中
ひっちゃく	必着
ひっすかく	必須格
ひっしょく	筆触
ひっしょう	必勝
ひっしゅう	必修	必習
ひっこしや	引越し屋	引っ越し屋	引越屋
ひっきょう	畢竟
ひっきたい	筆記体
ひだんせい	非弾性
ひだりわき	左脇
ひだりより	左寄	左寄り
ひだりよつ	左四つ
ひだりよこ	左横
ひだりよう	左用
ひだりむね	左胸
ひだりむき	左向き
ひだりみみ	左耳
ひだりまわ	左回
ひだりまき	左巻	左巻き
ひだりまえ	左前
ひだりほほ	左頬
ひだりひじ	左肘
ひだりひざ	左膝
ひだりはじ	左端
ひだりはし	左端
ひだりのり	左乗
ひだりなげ	左投げ
ひだりてぶ	左手部
ひだりづめ	左詰め
ひだりぜん	左膳
ひだりした	左下
ひだりこし	左腰
ひだりきき	左利き
ひだりがわ	左側
ひだりかた	左肩
ひだりおく	左奥
ひだりえだ	左枝
ひだりうで	左腕
ひだりうち	左打ち
ひだりうえ	左上
ひだりあし	左足
ひだかけん	日高研
ひたちやま	常陸山
ひたちべん	日立弁
ひたちばん	日立版
ひたちせい	日立製
ひたちけい	日立系
ひたかくし	直隠し
ひたいぎわ	額際
ひたいがみ	額髪
ひたいかく	非対角
ひたいおう	非対応
ひぞうぶつ	被造物
ひぞうっこ	秘蔵っ子
ひそんざい	非存在
ひそうかん	非相関	悲壮感	悲愴感
ひせんろん	非戦論
ひせんでん	非宣伝
ひせんけい	非線型	非線形
ひせつぞく	非接続
ひせきぶん	被積分
ひせいほう	非正方
ひせいてき	非静的
ひせいそく	非正則
ひせいじん	非成人
ひずみりつ	歪率
ひじりばし	聖橋
ひじょすう	被除数
ひじょうに	非常に
ひじょうじ	非常時
ひしょじょ	非処女
ひしょしつ	秘書室
ひしょかん	秘書官
ひしゃたい	被写体
ひしゃかく	飛車角
ひしつない	皮質内
ひしおいろ	醤色
ひざまくら	膝枕
ひざこぞう	膝小僧
ひざぐるま	膝車
ひざくりげ	膝栗毛
ひざがしら	膝頭
ひさんいつ	非散逸
ひさみどう	久美堂
ひさつせん	肥薩線
ひさしぶり	久しぶり	久し振り
ひさくせい	非作成
ひさかたぶ	久方振
ひさいしゃ	被災者
ひごうほう	非合法
ひこたろう	彦太郎
ひこくみん	非国民
ひこくにん	被告人
ひこくがわ	被告側
ひこうりつ	非効率
ひこうびん	飛行便
ひこうにん	非公認
ひこうてい	飛行艇
ひこうたい	飛行隊
ひこうせん	飛行船
ひこうせき	飛行石
ひこうしん	粃糠疹
ひこうしき	非公式
ひこうかい	非公開
ひげんてい	非限定
ひげんじつ	非現実
ひげねけい	鬚根系	ひげ根系
ひげきてき	悲劇的
ひげきせい	悲劇性
ひけんじゃ	被検者	被験者
ひけんしゃ	被検者	被験者
ひけんさく	被検索
ひけってい	非決定
ひけそうば	引け相場
ひけいやく	非契約
ひけいしき	非形式
ひぐちけん	樋口研
ひぐちうち	火口内
ひくうてい	飛空挺	飛空艇
ひくいどり	火喰鳥
ひぎんこう	非銀行
ひきんぞく	非金属	卑金属
ひきんしつ	非均質
ひきんいつ	非均一
ひきわたし	引渡	引渡し
ひきりょう	引両
ひきのばし	引き伸ばし
ひきとりて	引き取り手	引取手
ひきでもの	引出物
ひきつづき	引続き	引き続き
ひきつえん	非喫煙
ひきちだい	引地台
ひきたえき	引田駅
ひきずりだ	引き摺り出	引きずり出
ひきずりこ	引き摺り込	引きずり込
ひきこもり	引きこもり
ひきがたり	弾き語り
ひきがえる	蟇蛙	蟾蜍
ひきかたり	弾き語り
ひきおとし	引き落とし
ひきうけて	引き受け手	引受け手
ひきあわせ	引合せ
ひがんばな	彼岸花
ひがしよか	東与賀
ひがしゆり	東由利
ひがしやま	東山
ひがしもん	東門
ひがしむろ	東牟婁
ひがしむら	東村
ひがしむき	東向き
ひがしまち	東町
ひがしふじ	東富士
ひがしばる	東原
ひがしはら	東原
ひがしはま	東浜
ひがしなだ	東灘
ひがしなか	東中
ひがしとう	東棟
ひがしつの	東津野
ひがしちば	東千葉
ひがしちく	東地区
ひがしじま	東島
ひがしこう	東高
ひがしぐち	東口
ひがしくち	東口
ひがしがわ	東側
ひがしかん	東館
ひがしかわ	東川
ひがしかも	東加茂
ひがしかた	東方
ひがしかぜ	東風
ひがしえき	東駅
ひがしうわ	東宇和
ひがしうら	東浦
ひがしいず	東伊豆
ひがしいけ	東池
ひがいしゃ	被害者
ひがいがわ	被害側
ひがいがく	被害額
ひかんよう	非寛容
ひかんてき	悲観的
ひかんつう	非貫通
ひかんせん	非感染
ひかんさん	比換算
ひかわまる	氷川丸
ひかりもの	光り物
ひかりだい	光台
ひかりじき	光磁気
ひかそしき	皮下組織
ひかしぼう	皮下脂肪
ひかげもの	日陰者
ひかくろん	比較論
ひかくほう	比較法
ひかくてき	比較的
ひかくてい	非確定
ひかくきじ	比較記事
ひかくおん	比較音
ひかぎゃく	非可逆
ひかえしつ	控室	控え室
ひかいてん	非回転
ひかいせき	被解析
ひかいいん	非会員
ひおんせい	非音声
ひおうどう	非王道
ひえしょう	冷え性
ひえいざん	比叡山
ひうちょう	日宇町
ひうちやま	火打山
ひうちいし	燧石	火打ち石
ひいれしき	火入式
ひいなぼん	雛本
はんわどう	阪和道
はんわせん	阪和線
はんりょく	反力
はんりょう	半量
はんりゅう	伴流
はんようし	反陽子
はんようき	汎用機
はんようか	汎用化
はんむげん	半無限
はんみょう	斑猫
はんぼうき	繁忙期
はんぼいん	半母音
はんぺいた	半平太
はんぷけん	頒布権
はんぷくし	反復子
はんぷかい	頒布会
はんぶるぐ	漢堡
はんふだい	阪府大
はんぴれい	反比例
はんびらき	半開き
はんひれい	反比例
はんばいや	販売屋
はんばいぶ	販売部
はんばいび	販売日
はんばいひ	販売費
はんばいじ	販売時
はんばいき	販売機
はんばいか	販売課
はんねいか	半値以下
はんにゅう	搬入
はんにゃじ	般若寺
はんにっし	班日誌
はんにちご	半日後
はんとしご	半年後
はんとけい	反時計
はんでんし	反電子
はんてんじ	反転時
はんてんき	反転器
はんていぶ	判定部
はんていき	判定機
はんていが	判定勝
はんつきご	半月後
はんちょう	班長	反跳
はんちゅう	藩中	範衷	範中	範疇
はんちゃん	半荘
はんちはば	半値幅
はんだづけ	半田付け
はんだずけ	半田付け
はんだいり	阪大理
はんたんい	班単位
はんたいは	反対派
はんたいじ	繁体字
はんたいご	反対語
はんそくま	反則負
はんそうは	搬送波
はんそうき	搬送機
はんせんは	反戦派
はんせいふ	反政府
はんせいき	半世紀
はんじょく	繁縟
はんじょう	繁盛	繁昌	半畳	犯情
はんじゅく	半熟
はんじゅう	半獣
はんじもの	判じ物
はんじどう	半自動
はんじせい	反磁性
はんじかん	半時間
はんしょく	飯食	蕃殖	繁殖
はんしょう	反照	反証	半生	半焼	汎称	半鐘
はんしゅつ	搬出
はんしゅう	半周
はんしゃろ	反射炉
はんしゃは	反射波
はんしぼん	半紙本
はんざいご	犯罪後
はんさよう	反作用
はんごろし	半殺し
はんごほう	反語法
はんごてき	反語的
はんこてい	半固定
はんこけい	半固形
はんこうき	反抗期
はんげんご	半言語
はんげんき	半減期
はんげんか	半減化
はんけんじ	判検事
はんぎょく	半玉
はんぎゃく	叛逆	反逆
はんきょり	汎距離
はんきょう	般教	反共	反響
はんきゅう	半休	半球	阪急	半弓	阪九
はんきかん	半規管
はんがるい	版画類
はんがりー	洪牙利
はんがてん	版画展
はんがえし	半返し
はんかんひ	販管費
はんかつう	半可通
はんかせい	汎化性
はんかさん	半加算
はんかくさ	半可臭
はんかがい	繁華街
はんいめい	範囲名
はんいない	範囲内
はんいがい	範囲外
はわいとう	ハワイ島
はれつせい	破裂性
はれつおん	破裂音
はれすがた	晴れ姿
はるやすみ	春休み
はるみない	晴海内
はるみだい	晴美台
はるまつり	春祭	春祭り
はるばしょ	春場所
はるなさん	榛名山
はるだんじ	春団次
はるごころ	春心
はるけいば	春競馬
はるがすみ	春霞
はるうらら	春麗
はるいがい	春以外
はりまびと	播磨人
はりまなだ	播磨灘
はりまなげ	波離間投げ
はりのやま	針の山
はりのあな	針の穴
はりねずみ	蝟	針鼠
はりじょう	針状
はりしごと	針仕事
はりぐすり	貼り薬
はりくよう	針供養
はらみった	波羅蜜多
はらまちだ	原町田
はらひでこ	原日出子
はらはちぶ	腹八分
はらのまち	原町	原ノ町
はらのなか	腹の中
はらどけい	腹時計
はらづもり	腹積り	腹積もり
はらつづみ	腹鼓
はらちがい	腹違い
はらせつこ	原節子
はらじゅく	原宿
はらごしら	腹拵
はらごころ	腹心
はらぐあい	腹具合
はらくだり	腹下り
はらくだし	腹下し
はらがまえ	腹構え
はらいわた	払い渡
はらいもど	払戻	払い戻
はらいどの	払殿
はらいだし	払い出し
はらいさげ	払い下げ	払下げ
はらいごし	払い腰
はらいこみ	払込	払込み	払い込み
はらいかわ	祓川	秡川
はらいかた	払い方
はやわかり	早分り
はやりもの	流行り物
はやみばん	早見板
はやままち	葉山町
はやばまい	早場米
はやとちり	早とちり
はやじまい	早仕舞
はやしばら	林原
はやしかた	囃子方
はやがわり	早変わり
はやがてん	早合点
はやおくり	速送り	早送り
はやうまれ	早生れ	早生まれ
はやあるき	速歩き
はやあがり	早上がり
はもんほう	波紋法
はものるい	刃物類
はめんほう	波面法
はめつもの	破滅物
はめつぶつ	破滅物
はめつてき	破滅的
はめつがた	破滅型
はめつかん	破滅感
はめごろし	嵌め殺し
はみがきこ	歯磨き粉
はまりやく	填役	嵌まり役	嵌役
はままつし	浜松市
はまべちか	浜辺近
はまちょう	浜町
はまちどり	浜千鳥
はまきょう	浜響
はまきがた	葉巻型
はまおおつ	浜大津
はぼうほう	破防法
はほろせん	羽幌線
はふにうむ	Hf	Hafnium
ははこぐさ	母子草
ははきぐさ	帚草
ははおやに	母親似
はねまくら	羽根枕
はねぶとん	羽布団
はねっかえ	跳ねっ返
はねだおき	羽田沖
はねぐるま	羽根車
はにゅうだ	羽生田
はなわせん	花輪線
はなれわざ	離れ業
はなればな	離れ離
はなやなぎ	花柳
はなやしき	花屋敷
はなもよう	花模様
はなめがね	鼻眼鏡
はなむすび	花結び
はなみどき	花見時
はなみどう	花御堂
はなみづき	花見月
はなみずき	花水木
はなみざけ	花見酒
はなまつり	花祭	花祭り
はなまがり	鼻曲り
はなふぶき	花吹雪
はなびだま	花火玉
はなばんか	花挽歌
はなばたけ	花畑
はなばしら	鼻柱
はなばさみ	花鋏
はなのまき	花巻
はなのした	鼻の下
はなのえん	花宴
はなどけい	花時計
はなづまり	鼻詰まり	鼻詰り
はなつまみ	鼻摘
はなっぱし	鼻っぱし
はなっつら	鼻っ面
はなだより	花便り
はなだいろ	縹色
はなずもう	花相撲
はなじるし	花印
はなしべた	話下手
はなしてき	話的
はなしずき	話好き
はなしごえ	話し声
はなしがい	放し飼い
はなしかた	話し方
はなしあう	話し合う
はなしあい	話合い	話し合い	話合
はなざんげ	花ざんげ
はなざくら	花桜
はなざかり	花盛り
はなごよみ	花暦
はなごおり	花氷
はなことば	花言葉
はなぐもり	花曇	花曇り
はなぐすり	鼻薬
はながつお	花鰹
はながすみ	花霞
はなかつら	花鬘
はなかくし	鼻隠し
はないずみ	花泉
はなあらし	鼻嵐
はなあさぎ	花浅葱
はどうほう	波動砲
はどうせい	波動性
はどうけん	波動拳
はとろんし	ハトロン紙
はとばいろ	鳩羽色
はとどけい	鳩時計
はてんこう	破天荒
はづくろい	羽繕い
はつわらい	初笑い	初笑
はつわしゃ	発話者
はつもうで	初詣
はつめいか	発明家
はつまいり	初参り
はつぶたい	初舞台
はつびょう	発病
はつひので	初日の出
はつひこう	初飛行
はつばしょ	初場所
はつばいび	発売日
はつばいじ	発売時
はつばいご	発売後
はつどうき	発動機
はつでんき	発電機	発電気	発電器
はつだより	初便り
はつだせき	初打席
はつたろう	初太郎
はつぜっく	初節句
はつせいは	初制覇
はつすべり	初滑り
はつじょう	発条	発情
はつじこく	発時刻
はつしゅび	初守備
はつしごと	初仕事
はつざくら	初桜
はつさんか	初参加
はつごおり	初氷
はつげんじ	発言時
はつげいこ	初稽古
はつぎしゃ	発議者
はつがつお	初鰹
はつがしら	発頭
はつかがみ	初鏡
はつかいち	廿日市
はつおんき	発音器
はつあんだ	初安打
はっぴょう	発表
はっぴゃく	八百
はってんき	発展期
はっちょう	八丁
はっちゅう	発注	八中
はっちゃく	発着
はったんだ	八反田
はったつど	発達度
はっそうじ	発送時
はっそうご	発送後
はっそうき	発走機
はっせいび	発生日
はっせいじ	発生時
はっせいご	発生後
はっせいき	発生器
はっしんぶ	発信部
はっしんび	発信日
はっしんじ	発進時	発震時	発信時
はっしんし	発振子
はっしんき	発信器	発信機	発振機	発振器
はっしょく	発色
はっしょう	八章	発祥	発症	八省	発消
はっしゅつ	発出
はっしゅち	ハッシュ値
はっしゃび	発車日
はっしゃじ	発車時	発射時
はっしゃご	発車後
はっしうむ	Hassium	Hs
はっこよう	発呼用
はっこうぶ	発光部
はっこうび	発行日
はっこうだ	八甲田
はっこうじ	発行時
はっこうき	発行機
はっきょう	発狂
はっきゅう	薄給	白球	発給
はっかんび	発刊日
はっかりつ	発火率
はっかてん	発火点
はっかせき	発火石
はちろぐん	八路軍
はちりゅう	八竜
はちまんざ	八幡座
はちぶんめ	八分目
はちぶんぎ	八分儀
はちばんめ	八番目
はちじょう	鉢状	八条	八丈
はちじゅう	八十
はちざかな	鉢肴
はちごうめ	八合目
はちけんや	八軒屋
はちおうじ	八王子
はちあわせ	鉢合わせ	鉢合せ
はだぶとん	肌布団
はだざわり	肌触り
はだかむぎ	裸麦
はだかうま	裸馬
はたらきて	働き手
はたらきす	働き過
はたらきか	働き掛
はたのだい	旗の台
はたのえき	秦野駅
はたじるし	旗印
はたしょう	秦荘
はたしあい	果たし合い	果し合い
はたけやま	畑山	畠山
はたけなか	畠中
はたけちが	畑違
はたきこみ	叩き込み
はたがしら	旗頭
はそんりつ	破損率
はそんじこ	破損事故
はせいぶつ	派生物
はせいてき	派生的
はせいげん	派生源
はせいけい	派生型
はずかしめ	辱め
はすむかい	斜向かい	斜向い
はじょうろ	波状路
はじしらず	恥知らず
はじさらし	恥曝し
はしわたし	橋渡し
はしりよみ	走り読み
はしりまわ	走り回
はしりつづ	走り続
はしりがき	走り書き
はしりかた	走り方
はしらたに	柱谷
はしゅつふ	派出婦
はしやすめ	箸休め
はしのすけ	橋之助
はしたがね	端た金	端金
はしごだん	梯子段
はしごしゃ	梯子車	はしご車
はしござけ	梯子酒
はざまぐみ	間組
はざかいき	端境期
はさんほう	破産法
はさんしゃ	破産者
はさみつけ	挾み付け
はさみうち	挾み打ち	挟み打ち	挟み撃ち	挾み撃ち
はさつおん	破擦音
はこねわん	箱根湾
はこえふう	箱絵風
はげあたま	禿頭
はけんさき	派遣先
はけいれい	波形例
はぐれぐも	浮浪雲
はぐるまひ	歯車比
はくれんが	白煉瓦
はくりょく	迫力
はくりゅう	白龍	白竜
はくりざい	剥離剤
はくりきこ	薄力粉
はくめんか	薄面化
はくぶつし	博物誌	博物史
はくびょう	白描
はくびせん	伯備線
はくひょう	薄氷	白票
はくばえき	白馬駅
はくどうか	白銅貨
はくちょう	白丁	白鳥
はくちゅう	白昼	伯仲
はくじょう	白状	薄情
はくじゃく	薄弱
はくじつむ	白日夢
はくしょく	白色
はくしゅう	白秋
はくしゃく	伯爵
はくしごう	博士号
はくきょい	白居易
はくがんし	白眼視
はぎまつり	萩まつり
はぎのまち	萩野町
はぎのつき	萩の月
はきそうじ	掃き掃除
はきじはん	破棄自判
はきくだし	吐き下し
はきいそう	破棄移送
はがいじめ	羽交締め	羽交い締め	羽交い絞め
はかりざら	秤皿
はかりごと	謀
はかりきり	量り切り
はかりうり	量り売り
はかまいり	墓参り
はかたわん	博多湾
はかたべん	博多弁
はかたふう	博多風
はかたびん	博多便
はかたはつ	博多発
はかたはく	博多泊
はかたかん	博多間
はかたえき	博多駅
はかせごう	博士号
はかじるし	墓標
はかいりつ	破壊率
はかいてき	破壊的
はかいそう	破戒僧
はかいしん	破壊神
はかいしゃ	破壊者
はおうでん	覇王伝
はえたたき	蠅叩き
はいりょう	拝領
はいりゅう	配流
はいりほう	背理法
はいりくち	入り口
はいらんび	排卵日
はいゆうざ	俳優座
はいみょう	俳名
はいふよう	配布用
はいふもと	配布元
はいふぶん	配布分
はいふぶつ	配布物
はいふひん	配布品
はいふばん	配付版
はいふじき	配布時期
はいふしゃ	配布者
はいふさき	配布先
はいふきや	灰吹屋
はいびょう	肺病
はいにょう	排尿
はいにゅう	胚乳
はいつくば	這い蹲
はいちょう	拝聴
はいちやく	配置薬
はいちゃく	敗着	廃嫡
はいちせい	背地性
はいちがえ	配置替え	配置換
はいたてき	排他的
はいたつじ	配達時
はいせんず	配線図
はいせんじ	敗戦時
はいせんご	敗戦後
はいすいき	排水機
はいじょう	廃城
はいしょく	配色	憊色	敗色
はいしょう	廃娼	拝承	敗将
はいしゅつ	輩出	排出
はいしゃび	廃車日
はいしゃく	拝借
はいしせん	廃止線
はいしえき	廃止駅
はいしあん	廃止案
はいごれい	背後霊
はいけいが	背景画
はいぐうし	配偶子
はいぎょう	廃業
はいきょく	廃局	廃曲
はいきょう	俳協	背教
はいきゅう	廃休	配球	排球	配給
はいきゃく	廃却
はいきべん	排気弁
はいきぶつ	廃棄物
はいきのう	肺機能
はいきねつ	排気熱
はいきしゅ	肺気腫
はいきしき	排気式
はいきこう	排気口
はいきけい	排気系
はいきがわ	排気側
はいきがす	排気ガス
はいきかん	排気管
はいきおん	排気音
はいきあつ	排気圧
はいがまい	胚芽米
はいかんじ	廃刊時
はいかぐら	灰神楽
はいえんか	排煙家
ほんろんぶん	本論文
ほんれんさい	本連載
ほんらいべつ	本来別
ほんらいてき	本来的
ほんやばけい	本耶馬渓
ほんやくもの	翻訳物
ほんやくぼん	翻訳本
ほんやくぶん	翻訳文
ほんやくばん	翻訳版
ほんやくしょ	翻訳書
ほんやくしゃ	翻訳者
ほんやくけん	翻訳権
ほんやくけい	翻訳系
ほんやくきじ	翻訳記事
ほんめんきょ	本免許
ほんぽうはつ	本邦初
ほんほうほう	本方法
ほんほうそう	本放送
ほんほうしき	本方式
ほんほうこく	本報告
ほんほうえい	本放映
ほんぶんまつ	本文末
ほんぶんしょ	本文書
ほんぶふめい	本部不明
ほんぶっけん	本物件
ほんぶちょう	本部長
ほんぶちいき	本部地域
ほんぶしざい	本部資材
ほんばんよう	本番用
ほんばんまえ	本番前
ほんはつめい	本発明
ほんはすぬま	本蓮沼
ほんのうてき	本能的
ほんにんだん	本人談
ほんにんたち	本人達
ほんにんあて	本人宛
ほんないよう	本内容
ほんとうない	本島内
ほんとうこう	本投稿
ほんでんわき	本電話機
ほんてんまえ	本店前
ほんてんちか	本店地下
ほんていあん	本提案
ほんちょうし	本調子
ほんちょうさ	本調査
ほんだぎけん	本田技研
ほんだいがく	本大学
ほんたいろん	本体論
ほんたいよう	本体用
ほんたいない	本体内
ほんたいせい	本態性
ほんたいがわ	本体側
ほんたいかん	本体間
ほんたいかい	本大会
ほんぞうがく	本草学
ほんせんぞい	本線沿い
ほんせんこう	本専攻
ほんせんぎふ	本線岐阜
ほんせんがわ	本線側
ほんせんかい	本選会
ほんせいほん	本製本
ほんせいひん	本製品
ほんじつよる	本日夜
ほんじっけん	本実験
ほんじしょう	本時称
ほんじぎょう	本事業
ほんしゅほう	本手法
ほんしゃまえ	本社前
ほんしゃびる	本社ビル
ほんしゃがわ	本社側
ほんしつてき	本質的
ほんしおがま	本塩釜
ほんさくひん	本作品
ほんさいよう	本採用
ほんごくむけ	本国向け
ほんごくほう	本国法
ほんごくばん	本国版
ほんごうだい	本郷台
ほんごうしん	本郷新
ほんこんもの	香港物
ほんこんはつ	香港発
ほんこんとう	香港島
ほんこんつう	香港通
ほんこんせん	香港線
ほんこんせい	香港製
ほんこまごめ	本駒込
ほんこうえん	本講演
ほんけんとう	本検討
ほんけってい	本決定
ほんけいやく	本契約
ほんけいさい	本掲載
ほんぐうさん	本宮山
ほんくげぬま	本鵠沼
ほんがっかい	本学会
ほんかんすう	本関数
ほんかくもの	本格物
ほんかくてき	本格的
ほんかいほう	本会報
ほんうんよう	本運用
ほんいんぼう	本因坊
ほんいーそー	混一色
ほんあんぶつ	翻案物
ほわんちゅー	黄酒
ほるもんざい	ホルモン剤
ほりゅうぶん	保留分
ほりゅうきん	保留金
ほりゅうおん	保留音
ほりだしもの	掘り出し物
ほらがとうげ	洞ヶ峠
ほゆうりょう	保有量
ほほえみかえ	微笑み返
ほねつりょく	保熱力
ほねおりぞん	骨折り損
ほにゅうるい	哺乳類
ほにゅうびん	哺乳瓶
ほどこしもの	施し物
ほどうきょう	補導協	歩道橋
ほとけごころ	仏心
ほていあおい	布袋葵
ほつうきょう	保通協
ほっぽうせん	北方線
ほっぽうけい	北方系
ほっとうにん	発頭人
ほったてごや	掘っ建て小屋
ほっそくかい	発足会
ほっしんぶつ	法身仏
ほっけしゅう	法華宗
ほっけきょう	法華経
ほっかいどう	北海道
ほちゅうあみ	捕虫網
ほたんちょう	ホ短調
ほたるまつり	蛍祭
ほたるじゃや	蛍茶屋
ほたるがいけ	蛍ケ池	蛍池
ほぞんろくが	保存録画
ほぞんりよう	保存利用
ほぞんりょう	保存量	保存料
ほぞんばしょ	保存場所
ほぞんにちじ	保存日時
ほぞんしょく	保存食
ほぞんこうい	保存行為
ほぞんきかん	保存期間
ほぞんかんり	保存管理
ほぞんかのう	保存可能
ほぞんおんど	保存温度
ほそくていど	補足程度
ほそかわはん	細川藩
ほそかわがみ	細川紙
ほそえちょう	細江町
ほそうどうろ	舗装道路
ほそうこうじ	舗装工事
ほぜいちいき	保税地域
ほぜいそうこ	保税倉庫
ほぜいうわや	保税上屋
ほせいりょう	補正量
ほせいよさん	補正予算
ほせいしょり	補正処理
ほせいきのう	補正機能
ほせいがかく	補正画角
ほせいかのう	補正可能
ほせいかくど	補正角度
ほせいかいろ	補正回路
ほじょよさん	補助予算
ほじょどうし	補助動詞
ほじょていり	補助定理
ほじょたんい	補助単位
ほじょそうび	補助装備
ほじょさんか	補助参加
ほじょきごう	補助記号
ほじょきかん	補助機関
ほじょきおく	補助記憶
ほじょかんじ	補助漢字
ほじゅうぶつ	補充物
ほじゅうえき	補充液
ほじくりかえ	穿り返
ほしょくしゃ	捕食者
ほしょうれい	蒲松齢
ほしょうぶん	補償分
ほしょうにん	保証人
ほしょうそち	補償措置
ほしょうしょ	保証書
ほしょうぎれ	保証切れ
ほしょうきん	保証金	補償金
ほしょうがた	補償型
ほしょうがく	保証額
ほしゅりょう	保守料
ほしゅぶひん	保守部品
ほしゅしゅぎ	保守主義
ほしゅかんり	保守管理
ほしゅかかく	保守価格
ほしゅうよう	補修用
ほしゅうごう	補集合
ほしゃくきん	保釈金
ほしつりょく	保湿力
ほししんいち	星新一
ほししいたけ	干椎茸	干し椎茸
ほしくさもく	Eriocaulales	ホシクサ目
ほしうらない	星占い
ほしいってつ	星一徹
ほごぼうえき	保護貿易
ほごどうぶつ	保護動物
ほごぞくせい	保護属性
ほごせいさく	保護政策
ほごしょぶん	保護処分
ほごかんぜい	保護関税
ほごかんさつ	保護観察
ほごあずかり	保護預り
ほこうちゅう	歩行中
ほこうきょり	歩行距離
ほけんりょう	保険料
ほけんせいど	保険制度	保健制度
ほけんしょう	保健省	保険証
ほけんぎょう	保険業
ほけんがっか	保健学科
ほけんかがく	保険価額
ほくりくどう	北陸道
ほくりくちく	北陸地区
ほくりくせん	北陸線
ほくりくしぶ	北陸支部
ほくようだい	北陽台
ほくほくとう	北々東	北北東
ほくほくせい	北北西
ほくべいばん	北米版
ほくべいさん	北米産
ほくとのけん	北斗の拳
ほくとうがわ	北東側
ほくてんゆう	北天佑
ほくだいない	北大内
ほくそうせん	北総線
ほくせいそう	北誠荘
ほくせいせん	北勢線
ほくせいしょ	北斉書
ほくせいがわ	北西側
ほくしんえつ	北信越
ほくおうてき	北欧的
ほくおうけい	北欧系
ほきょうせん	補強線
ほきょうざい	補強材
ほきゅうよう	補給用
ほきゅうへい	補給兵
ほきゅうぶつ	補給物
ほきゅうせん	補給線
ほきゅうかん	補給艦
ほかんばしょ	保管場所
ほかんていり	補間定理
ほかんちゅう	保管中
ほかんしょり	補間処理	補完処理
ほかんこてい	補間固定
ほかんきのう	補完機能
ほかんきげん	保管期限
ほかんかへん	補間可変
ほかなんにん	他何人
ほかすうめい	他数名
ほかおおぜい	他多勢	他大勢
ほかいちめい	他一名
ほおんりょく	保温力
ほうろうへき	放浪癖
ほうろうしゃ	放浪者
ほうれんそう	鳳蓮草	法蓮草	菠薐草	ほうれん草
ほうれきほん	宝暦本
ほうりんこう	法輪功
ほうりゅうじ	法隆寺
ほうりつろん	法律論
ほうりつてき	法律的
ほうりつしん	法律審
ほうりつこん	法律婚
ほうりつがく	法律学
ほうりつあん	法律案
ほうらくめん	包絡面
ほうらくせん	包絡線
ほうらいさん	蓬莱山
ほうらいけん	宝来研
ほうやくずみ	邦訳済
ほうもんとし	訪問都市
ほうもんだん	訪問団
ほうもんしゃ	訪問者
ほうもんさき	訪問先
ほうもんこく	訪問国
ほうめんべつ	方面別
ほうめんたい	方面隊
ほうめんぐん	方面軍
ほうむしょう	法務省
ほうむきょく	法務局
ほうほうろん	方法論
ほうほうなど	方法等
ほうへきざん	豊碧山
ほうぶんしゃ	芳文社
ほうぶつめん	放物面
ほうぶつせん	抛物線	放物線
ほうふくそち	報復措置
ほうのうきん	奉納金
ほうねつばん	放熱板
ほうどうじん	報道陣
ほうどうかん	報道官
ほうとうない	砲塔内
ほうでんかん	放電管
ほうてつがく	法哲学
ほうてきめん	法的面
ほうてきほご	法的保護
ほうてきばつ	法的罰
ほうてきちい	法的地位
ほうてきぎむ	法的義務
ほうてきいち	法的位置
ほうていない	法定内
ほうていしき	方程式
ほうていけい	法定刑
ほうちぷれい	放置プレイ
ほうちにりん	放置二輪
ほうちしゅぎ	法治主義
ほうちこっか	法治国家
ほうちきかん	放置期間
ほうだんがた	砲弾型
ほうだんかい	放談会
ほうたいけい	法体系
ほうぞうかん	法蔵館
ほうそくてき	法則的
ほうそくせい	法則性
ほうそうわく	放送枠
ほうそうよう	放送用
ほうそうもう	放送網
ほうそうまえ	放送前
ほうそうほう	放送法
ほうそうぶん	放送分
ほうそうはん	放送班
ほうそうせき	放送席
ほうそうじこ	放送事故
ほうそうじき	放送時期
ほうそうげき	放送劇
ほうそうけん	放送権
ほうそうがた	放送型
ほうそうかい	法曹界
ほうせんいん	宝泉院
ほうせきるい	宝石類
ほうせきばこ	宝石箱
ほうせきてん	宝石店
ほうせいだい	法政大
ほうすいしゃ	放水車
ほうじんめい	法人名
ほうじんぶつ	報身仏
ほうじんなど	法人等
ほうじんぜい	法人税
ほうじんかく	法人格
ほうじょうじ	法成寺
ほうじょうし	北条氏
ほうじょうけ	北条家
ほうじょうき	方丈記
ほうじょうえ	放生会
ほうしんしょ	方針書
ほうしょがみ	奉書紙
ほうしょうじ	宝生寺
ほうしゅやま	宝珠山
ほうしゃのう	放射能
ほうしゃねつ	放射熱
ほうしゃてん	放射点
ほうしゃせん	放射線
ほうしゃせい	放射性
ほうしゃこう	放射光
ほうしゃげん	放射源
ほうしゃくじ	宝積寺
ほうしゃきど	放射輝度
ほうしゃおん	放射音
ほうしきけん	方式研
ほうしきかん	方式間
ほうこくぶん	報告文
ほうこくしょ	報告書
ほうこくしゃ	報告者
ほうこくぎむ	報告義務
ほうこくきじ	報告記事
ほうこくかい	報告会
ほうこくいた	報告致
ほうこうまく	方向幕
ほうこうべつ	方向別
ほうこうにん	奉公人
ほうこうてき	方向的
ほうこうせい	芳香性	方向性
ほうこうざい	芳香剤
ほうこうかん	方向感
ほうげきせん	砲撃戦
ほうげきしゅ	砲撃手
ほうけんてき	封建的
ほうけんせい	封建制
ほうきりゅう	伯耆流
ほうがんなげ	砲丸投げ
ほうがんせい	包含性
ほうがくけい	邦楽系
ほうがいねん	法概念
ほうかつてき	包括的
ほうかいれい	崩壊例
ほうかいまえ	崩壊前
ほうかいねつ	崩壊熱
ほうかいせき	方解石
ほうかいせい	法改正
ほうかいいん	法界院
ほうえいよう	放映用
ほうえいまえ	放映前
ほうえいぶん	放映分
ほうえいじき	放映時期
ほうえいけん	放映権
ほいこうろう	回鍋肉
ほいくりょう	保育料
ほいくよさん	保育予算
ほいくしせつ	保育施設
ほいくえんじ	保育園児
ほあんぶひん	保安部品
ほあんぶない	保安部内
ほあんぶいん	保安部員
ほあんちょう	保安庁
ほあんそうち	保安装置
ほあんせつび	保安設備
ほあんじょう	保安上
へんれいきん	返戻金
へんぽんりつ	返本率
へんぺいりつ	偏平率
へんぺいそく	偏平足	扁平足
へんぶんほう	変分法
へんびょうし	変拍子
へんばいりつ	変倍率
へんねんたい	編年体
へんどうはば	変動幅
へんどうかん	変動感
へんどうおん	変動音
へんとうせん	扁桃腺
へんとうえん	扁桃炎
へんでんじょ	変電所
へんでんしょ	変電所
へんちょうは	変調波
へんちょうど	変調度
へんちょうき	変調器
へんたいてき	変態的
へんたいごと	編隊毎
へんたいがな	変体仮名
へんそくてき	変則的
へんそうよう	返送用
へんそうさき	返送先
へんそうくだ	返送下
へんそううん	片層雲
へんせきうん	片積雲
へんせいもの	編成物
へんせいふう	偏西風
へんせいたん	編成端
へんせいがん	変成岩
へんすうめい	変数名
へんすうけい	変数型
へんしんよう	返信用
へんしんまえ	変身前
へんしんさき	返信先
へんしゅうや	編集屋
へんしゅうぶ	編集部
へんしゅうじ	編集時
へんしゅうご	編集後
へんしゅうき	編集機
へんしゃぞう	偏写像
へんしつてき	変質的
へんしつしゃ	変質者
へんざいせい	遍在性
へんさんしゃ	編纂者
へんこうよう	変更用
へんこうまく	偏光膜
へんこうまえ	変更前
へんこうぶん	変更分
へんこうばん	変更版	偏光板
へんこうてん	変更点
へんこうそち	変更措置
へんこうせい	変光星
へんこうしょ	変更書
へんこうさき	変更先
へんこうこう	偏向光
へんこういた	変更致
へんこうあん	変更案
へんけんてき	偏見的
へんけいほう	変形法
へんけいばん	変形版
へんけいたい	変形体
へんけいきん	変形菌
へんきゃくび	返却日
へんきゃくち	返却値
へんかんれつ	変換列
へんかんりつ	変換率
へんかんよう	変換用
へんかんまえ	返還前	変換前
へんかんほう	変換法
へんかんふく	返還含
へんかんてん	変換点
へんかんすう	偏関数
へんかんしき	変換式
へんかんさき	変換先
へんかんけい	変換系
へんかんきぐ	変換器具
へんかりょう	変化量
へんかぶぶん	変化部分
へんかはんい	変化範囲
へんかぐあい	変化具合
へんかきゅう	変化球
へんえんけい	辺縁系
へるくれすざ	ヘルクレス座
へやぜんたい	部屋全体
へぶらいもじ	ヘブライ文字
へびつかいざ	蛇遣い座
へびーきゅう	ヘビー級
へたんちょう	ヘ短調
へくとぐらむ	瓸
へきめんせん	壁面線
へきこういき	壁孔域
へいわりよう	平和利用
へいわどおり	平和通り
へいわしょう	平和賞
へいわしゅぎ	平和主義
へいれつてき	並列的
へいれつせい	並列性
へいれつしき	並列式
へいれつけい	並列系
へいれつがた	並列型
へいりょくさ	兵力差
へいりつせい	並立制
へいようばし	併用橋
へいめんばん	平面板
へいめんてき	平面的
へいめんせい	平面性
へいめんけい	平面型	平面系
へいめんきか	平面幾何
へいぼんしゃ	平凡社
へいほうせい	閉包性
へいほうこん	平方根
へいはちろう	平八郎
へいねんなみ	平年並
へいたんせん	兵站線
へいたいたち	兵隊達
へいたいあり	兵隊蟻
へいそくもう	閉塞網
へいそくかん	閉塞感
へいせいばん	平成版
へいすいめん	平水面
へいじょぶん	平叙文
へいじょうじ	平常時
へいじゅんか	平準化
へいじつよう	平日用
へいじつあさ	平日朝
へいしゃない	弊社内
へいしゃぞう	閉写像
へいしゃがい	弊社外
へいさちゅう	閉鎖中
へいさこうじ	閉鎖工事
へいさこうか	閉鎖効果
へいごうざい	併合罪
へいこうぼう	平行棒
へいこうほう	平行法
へいこうへき	平行壁
へいこうひん	並行品
へいこうてん	平衡点
へいこうてき	並行的
へいこうせん	並行線	平行線
へいこうせい	並行性
へいこうこう	平行光
へいこうけい	平衡系
へいこうがた	並行型	平行型
へいけいしき	閉形式
へいくうかん	閉空間
へいきんりつ	平均率	平均律
へいきんてん	平均点
へいきんてき	平均的
へいきんだい	平均台
へいきんいか	平均以下
へいきしょう	兵器廠
へいがっこう	兵学校
へいかとしょ	閉架図書
へいかつきん	平滑筋
へいかいしき	閉会式
へいおんぶじ	平穏無事
へいおんせつ	閉音節
へいいはぼう	弊衣破帽
へいあんどう	平安堂
ふんぞりかえ	踏ん反り返
ふんしゅうは	分周波
ふんしゃまえ	噴射前
ふんしゃしき	噴射式
ふんかんかく	分間隔
ふんいきてき	雰囲気的
ふんいきつた	雰囲気伝
ふわらいどう	付和雷同
ふろんりしき	負論理式
ふろうちょう	不老町
ふるまいざけ	振舞い酒
ふるほんかい	古本界
ふるほんいち	古本市
ふるどうぐや	古道具屋
ふるつわもの	古兵	古強者
ふるしんぶん	古新聞
ふるかつよう	フル活用
ふるかいてん	フル回転
ふりんあいて	不倫相手
ふりょうりつ	不良率
ふりょうひん	不良品
ふりょうばば	不良馬場
ふりょうけん	不料簡
ふりだしにん	振出人
ふりこみにん	振込人
ふりこみさき	振込先
ふりこどけい	振り子時計	振子時計
ふりこぐるま	振子車
ふりーきしゃ	フリー記者
ふらんしうむ	Fr	Francium
ふらいきゅう	フライ級
ふようりょく	浮揚力
ふようぶぶん	不要部分
ふようじょう	不養生
ふようかぞく	扶養家族
ふゆやまよう	冬山用
ふゆとうらい	冬到来
ふゆさくもつ	冬作物
ふゆげしょう	冬化粧
ふゆきとどき	不行届き
ふめんじょう	譜面上
ふめいりょう	不明瞭
ふみんしょう	不眠症
ふみきりない	踏切内
ふみきりじこ	踏切事故
ふまえどころ	踏まえ所
ふほうとうき	不法投棄
ふほうちたい	不法地帯
ふほうしよう	不法使用
ふほうしょじ	不法所持
ふほうこうい	不法行為
ふべんきょう	不勉強
ふへんりょう	不変量
ふへんふとう	不偏不党
ふへんねっと	不変ネット
ふへいふまん	不平不満
ふふくじゅう	不服従
ふびょうどう	不平等
ふはいぼうし	腐敗防止
ふはいしんわ	不敗神話
ふはいしゅう	腐敗臭
ふのうしょう	不能症
ふねかんけい	船関係
ふにんてあて	赴任手当
ふにんちゅう	赴任中
ふにんじょう	不人情
ふにんしょう	不妊症
ふにんきしゃ	不人気車
ふなばしかん	船橋間
ふなばしえき	船橋駅
ふなづみこう	船積港
ふなくいむし	船食虫
ふながいしゃ	船会社
ふないりまち	舟入町
ふどうひょう	浮動票
ふどうとうげ	不動峠
ふどうさんや	不動産屋
ふとわくない	太枠内
ふともももく	Myrtales	フトモモ目
ふところがみ	懐紙
ふとうりとく	不当利得
ふとうふくつ	不倒不屈	不撓不屈
ふとうきょり	不倒距離
ふでぶしょう	筆不精	筆無精
ふてんはちぶ	符点八分
ふてんそっと	普天率土
ふてくされる	不貞腐れる
ふてきちゅう	不的中
ふていじほう	不定時法
ふていしょう	不定称
ふていきてき	不定期的
ふていきけい	不定期刑
ふていかんし	不定冠詞
ふつつかもの	不束者
ふつごうてん	不都合点
ふつうよきん	普通預金
ふつうめいし	普通名詞
ふつうどうろ	普通道路
ふつうていど	普通程度
ふつうこうざ	普通口座
ふつうけつぎ	普通決議
ふつうきっぷ	普通切符
ふっとうてん	沸騰点
ふっとうせき	沸騰石
ふっこしゅぎ	復古主義
ふっこくばん	復刻版	覆刻版
ふっこくしょ	復刻書
ふっこうだい	福工大
ふっきいらい	復帰以来
ふっかつばん	復活盤
ふっかつせつ	復活説
ふっかつしゃ	復活者
ふっかつさい	復活祭
ふっかつげき	復活劇
ふっかすいそ	弗化水素
ふちんくうぼ	不沈空母
ふちょうしゃ	府庁舎
ふちゅうえき	府中駅
ふちゃくぶつ	付着物
ふちあんない	不知案内
ふだんしよう	普段使用
ふだんいしき	普段意識
ふたりどうじ	二人同時
ふたりしばい	二人芝居
ふたりしずか	二人静
ふたりかぞく	二人家族
ふたまたみち	二股道
ふたまたぶね	二股舟
ふたまたせん	二俣線
ふたまたがわ	二俣川
ふたばがおか	双葉ヶ丘
ふたつへんじ	二つ返事
ふたつつうち	不達通知
ふたごしまい	双子姉妹
ふたこしんち	二子新地
ふたえまぶた	二重瞼
ふたいじこう	付帯事項
ふたいこうそ	付帯控訴
ふたいけつぎ	付帯決議
ふぞくじしょ	付属辞書
ふぞくきのう	付属機能
ふせんしょう	不戦勝
ふせいりよう	不正利用
ふせいゆうし	不正融資
ふせいみゃく	不整脈
ふせいしよう	不正使用
ふせいしゅつ	不世出
ふせいこぴー	不正コピー
ふせいこうい	不正行為
ふせいげんり	父性原理
ふずいいきん	不随意筋
ふじんびょう	婦人病
ふじょりょう	扶助料
ふじゅんぶつ	不純物
ふじゅうぶん	不十分	不充分
ふじむらみき	藤村美樹
ふじむらさき	藤紫
ふじみぶんこ	富士見文庫
ふじみちょう	富士見町
ふじみがおか	富士見丘
ふじまりゅう	藤間流
ふじほうめん	富士方面
ふじへいげん	富士平原
ふじふいるむ	富士フイルム
ふじのみやし	富士宮市
ふじのうらば	藤裏葉
ふじつうせい	富士通製
ふじつうけん	富士通研
ふじそうけん	富士総研
ふじしゃしん	富士写真
ふじしまべや	藤島部屋
ふじさんろく	富士山麓
ふじさんへん	富士山編
ふじさんごう	富士参號
ふじさんがた	富士山型
ふじさわばし	藤沢橋
ふじさわえき	藤沢駅
ふじこふじお	藤子不二夫	藤子不二雄
ふじぎんこう	富士銀行
ふじおかえき	富士岡駅
ふじえだえき	藤枝駅
ふじうつぎか	Buddlejaceae	フジウツギ科
ふしょくせい	腐蝕性	腐食性
ふしょくざい	腐蝕剤
ふしょうにん	不承認
ふしょうじき	不正直
ふしょうしゃ	負傷者
ふしみじょう	伏見城
ふしまちづき	臥待月
ふしつりょう	負質量
ふざいひょう	不在票
ふざいちゅう	不在中
ふさんかしゃ	不参加者
ふさざくらか	フサザクラ科	Eupteleaceae
ふさくいはん	不作為犯
ふごうりろん	符号理論
ふごうりせい	不合理性
ふごうひょう	符号表
ふごうちょう	符号帳	符号長
ふごうそくど	符号速度
ふごうかほう	符合化法
ふこうちゅう	不幸中
ふけまちづき	更待月
ふぐりょうり	河豚料理
ふぐたいてん	不倶戴天
ふぐあいてん	不具合点
ふくわじゅつ	腹話術
ふくろんぶん	副論文
ふくろとだな	袋戸棚
ふくろだたき	袋だたき	袋叩き	袋叩
ふくろぞうし	袋草紙
ふくろじょう	袋状
ふくろこうじ	袋小路
ふくろくじゅ	福禄寿
ふくれっつら	脹れっ面	膨れっ面	ふくれっ面
ふくやまえき	福山駅
ふくめんよう	覆面用
ふくむきてい	服務規程
ふくみわらい	含み笑い
ふくみしさん	含み資産
ふくまさむね	福正宗
ふくまくえん	腹膜炎
ふくほうとう	副砲塔
ふくへいそう	副兵装
ふくぶんせつ	複文節
ふくぶんすう	複分数
ふくぶちょう	副部長
ふくふくせん	複々線	複複線
ふくばんごう	副番号
ふくはんのう	副反応
ふくはんそう	副搬送
ふくどくほん	副読本
ふくとうこう	複投稿
ふくそぶぶん	複素部分
ふくそすうち	複素数値
ふくそくるい	腹足類
ふくそうりん	複層林
ふくそうさい	副総裁
ふくそうかく	輻輳角
ふくせってん	副節点
ふくせいわざ	複製技
ふくせいもと	複製元
ふくせいぶつ	複製物
ふくせいひん	複製品
ふくせいけん	複製権
ふくせいかん	複製間
ふくすうれい	複数例
ふくすうもじ	複数文字
ふくすうめい	複数名
ふくすうまい	複数枚
ふくすうほん	複数本
ふくすうはん	複数犯
ふくすうねん	複数年
ふくすうにん	複数人
ふくすうだい	複数台
ふくすうしゅ	複数種
ふくすうごび	複数語尾
ふくすうけい	複数形
ふくすうかん	複数艦
ふくすうかい	複数回
ふくすうおん	複数音
ふくじんづけ	福神漬	福神漬け
ふくじょうし	腹上死
ふくじゅそう	福寿草
ふくじしょう	副時称
ふくじこうか	副次効果
ふくしゅせき	副主席
ふくしゅしつ	副手室
ふくしゅかん	副主幹
ふくしゅうき	復讐鬼
ふくしゃねつ	輻射熱
ふくしゃてん	輻射点
ふくしゃせん	輻射線
ふくしゃしつ	複写室
ふくしまだい	福島大
ふくしまけん	福島県
ふくしまえき	福島駅
ふくしつしき	副室式
ふくしこっか	福祉国家
ふくしきぼき	複式簿記
ふくしがっか	福祉学科
ふくざつたき	複雑多岐
ふくざつせい	複雑性
ふくざつけい	複雑系
ふくさんぶつ	副産物
ふくさいぼう	副細胞
ふくごうまく	複合膜
ふくごうほう	復号法
ふくごうてき	複合的
ふくごうたい	複合体
ふくごうざい	複合材
ふくごうこう	複合項
ふくごうがた	複合型
ふくごうかこ	複合過去
ふくごうかく	複合核
ふくごうおん	複合音
ふくこうまえ	福高前
ふくこうない	腹腔内
ふくこうがん	副睾丸
ふくげんりつ	復元率
ふくげんばん	復元版
ふくけいしき	副形式
ふくくっせつ	複屈折
ふくぎちょう	副議長
ふくがんてき	複眼的
ふくがじょう	覆瓦状
ふくおんせい	副音声
ふくおかびん	福岡便
ふくおかはつ	福岡発
ふくおかちく	福岡地区
ふくおかだい	福岡大
ふくおかせん	福岡線
ふくおかこう	福岡校
ふくおかけん	福岡県
ふくおかかん	福岡間
ふくおかえき	福岡駅
ふくえんせん	福塩線
ふくいんしょ	福音書
ふくいんかん	福音館
ふぎょうせき	不行跡
ふきょくせい	負極性
ふきょうほう	不競法
ふきゅうりつ	普及率
ふきゅうばん	普及版
ふきゅうしき	普及式
ふきはつせい	不揮発性
ふきそくがた	不規則型
ふかんせいゆ	不乾性油
ふかんしょう	不感症	不干渉
ふかんしへい	不換紙幣
ふかむらさき	深紫
ふかほうしき	賦課方式
ふかへんどう	負荷変動
ふかぶんさん	負荷分散
ふかのうせい	不可能性
ふかでんあつ	負荷電圧
ふかっせいか	不活性化
ふかぞうだい	負荷増大
ふかぞうげん	負荷増減
ふかしようま	不可視妖魔
ふかざつおん	付加雑音
ふかけつせい	不可欠性
ふかけいげん	負荷軽減
ふかきんこう	負荷均衡
ふかかちぜい	付加価値税
ふかうらえき	深浦駅
ふかいにゅう	不介入
ふかいしすう	不快指数
ふかいぎいん	府会議員
ふえいようか	富栄養化
ふぇるみうむ	Fm	Fermium
ふうろそうか	Geraniaceae	フウロソウ科
ふうらいぼう	風来坊
ふうみんしゃ	風眠舎
ふうふどうし	夫婦同士
ふうふげんか	夫婦喧嘩
ふうふうてい	風風亭
ふうばぎゅう	風馬牛
ふうどびょう	風土病
ふうどしょく	風土色
ふうとうぼく	風倒木
ふうとうがた	封筒型
ふうちょうざ	風鳥座
ふうぞくつう	風俗通
ふうそくけい	風速計
ふうせんだま	風船玉
ふうすいがい	風水害
ふうしゃしき	風車式
ふうしゃがた	風車固
ふうしかでん	風姿花伝
ふうこうけい	風向計
ふうえいほう	風営法
ふうえいてん	風営店
ふぃんらんど	芬蘭
ふあんていか	不安定化
ふぁいるめい	ファイル名
ひんみんくつ	貧民窟
ひんみんがい	貧民街
ひんどじゅん	頻度順
ひんどじしょ	頻度辞書
ひんでぃーご	ヒンディー語
ひんしつてき	品質的
ひんしついじ	品質維持
ひんしじゅん	品詞順
ひんこんそう	貧困層
ひんこんしゃ	貧困者
ひんこんこく	貧困国
ひろんりてき	非論理的
ひろせどおり	広瀬通
ひろしまやき	広島焼
ひろしまべん	広島弁
ひろしまふう	広島風
ひろしまてん	広島店
ひろしまちく	広島地区
ひろしまだい	広島大	広島大学
ひろしません	広島戦
ひろしまさん	広島産
ひろしまけん	広島県
ひろしまきた	広島北
ひろしまがわ	広島側
ひろしまがす	広島ガス
ひろしまかん	広島間
ひろしまかき	広島牡蛎
ひろしまえき	広島駅
ひろさきだい	弘前大
ひれんじゃく	緋連雀
ひるめしだい	昼飯代
ひるあんどん	昼行灯
ひりんりてき	非倫理的
ひりようしゃ	非利用者
ひらぬまばし	平沼橋
ひらつかおき	平塚沖
ひらつかえき	平塚駅
ひらたちょう	平田町
ひらしゃいん	平社員
ひらきなおり	開き直り
ひらきかげん	開き加減
ひらおかえき	平岡駅
ひらあやまり	平謝り
ひよくれんり	比翼連理
ひようふたん	費用負担
ひょうろんき	評論器
ひょうろんか	評論家
ひょうりょう	秤量	兵糧
ひょうりゅう	漂流
ひょうめんは	表面波
ひょうめんか	表面化
ひょうほんち	標本値
ひょうほんか	標本化
ひょうびょう	縹渺	縹緲	縹眇
ひょうひょう	瓢々	飄飄	飄々
ひょうばんよ	評判良
ひょうばんき	評判記
ひょうてんか	氷点下
ひょうていち	評定値
ひょうちょう	憑弔	表徴	漂鳥	標徴
ひょうちゅう	標注	氷柱	標註	表中	氷中	標柱
ひょうちゃく	漂着
ひょうだいぶ	表題部
ひょうじわく	表示枠
ひょうじれい	表示例
ひょうじらん	表示欄
ひょうじよう	表示用
ひょうじょう	平調	評定	表情	氷上
ひょうじゅん	標準
ひょうじもじ	表示文字
ひょうじめん	表示面
ひょうじまど	表示窓
ひょうじほう	表示法
ひょうじぶつ	表示物
ひょうじばん	表示盤	表示板	表示版
ひょうじはば	表示幅
ひょうじとう	表示灯
ひょうじてき	表示的
ひょうじそう	表示相
ひょうじしき	表示式
ひょうじざか	表示坂
ひょうじさき	表示先
ひょうじけい	表示系
ひょうじぎむ	表示義務
ひょうじかん	表示管
ひょうじいち	表示位置
ひょうじいき	表示域
ひょうしょう	氷床	表彰	氷晶	表象	標章
ひょうしゅつ	表出
ひょうしゃく	評釈
ひょうしぬけ	拍子抜け
ひょうごもじ	表語文字
ひょうごふう	標語風
ひょうごけん	兵庫県
ひょうこうさ	標高差
ひょうげんは	表現派
ひょうげんご	表現語
ひょうぎかい	評議会
ひょうぎいん	評議員
ひょうきよう	表記用
ひょうきほう	表記法
ひょうきへい	驃騎兵
ひょうかよう	評価用
ひょうかほう	評価法
ひょうかばん	評価版
ひょうかてん	評価点
ひょうかてき	評価的
ひょうかぞん	評価損
ひょうかしゃ	評価者
ひょうかしき	評価式
ひょうかごさ	評価誤差
ひょうかけい	評価系
ひょうかきじ	評価記事
ひょうかがく	評価額	評価学
ひょうかおち	評価落
ひょうかえき	評価益
ひょうおんご	表音語
ひょういもじ	表意文字
ひょういてき	表意的
ひょうあつめ	票集め
ひゆうきてき	非有機的
ひゅうがなだ	日向灘
ひゅーむかん	ヒューム管
ひやそうめん	冷や素麺
ひゃっぽゆず	百歩譲
ひゃっぴょう	百票
ひゃっきえん	百鬼園
ひゃっかてん	百貨店
ひゃくぶんひ	百分比
ひゃくたろう	百太郎
ひゃくたたき	百叩き
ひゃくじゅう	百獣
ひゃくしょう	百姓	百勝
ひゃくしゅつ	百出
ひゃくぎょう	百行
ひめじひがし	姫路東
ひめじじょう	姫路城
ひめしんせん	姫新線
ひめかいどう	姫街道
ひむろさえこ	氷室冴子
ひみつへいき	秘密兵器
ひみつそしき	秘密組織
ひみつそうび	秘密装備
ひみつしれい	秘密指令
ひみつしゅぎ	秘密主義
ひまんしょう	肥満症
ひまらやすぎ	ヒマラヤ杉
ひぼうりょく	非暴力
ひほけんぶつ	被保険物
ひほけんしゃ	被保険者
ひぶんしょう	飛蚊症
ひぶんかてき	非文化的
ひぶつりてき	非物理的
ひふせいすう	非負整数
ひふかんかく	皮膚感覚
ひぴりんけい	非ピリン系
ひびややおん	日比谷野音	日比谷屋音
ひひょうしゃ	批評者
ひひょうがん	批評眼
ひばくりょう	被曝量	被爆量
ひはんりょく	批判力
ひはんりゆう	批判理由
ひはんひょう	批判票
ひはんたいは	非反対派
ひはんかくご	批判覚悟
ひはんいがい	批判以外
ひはかいてき	非破壊的
ひのようじん	火の用心
ひのみやぐら	火の見櫓
ひのとひつじ	丁未
ひのでじょし	日出女子
ひのきぶたい	桧舞台
ひねしょうが	陳生姜
ひねくれもの	捻くれ者
ひねくりまわ	捻くり回
ひにんじょう	非人情
ひにんしょう	非人称
ひにょうきか	泌尿器科
ひにちじょう	非日常
ひなんばしょ	避難場所
ひなんけつぎ	非難決議
ひなわじゅう	火縄銃
ひならずして	日ならずして
ひなまめほん	雛豆本
ひどうきてき	非同期的
ひどうきしき	非同期式
ひどうきがた	非同期型
ひとりわらい	独り笑い
ひとりよがり	一人善がり	独り善がり
ひとりむすめ	一人娘
ひとりむすこ	一人息子
ひとりぼっち	独りぼっち	一人法師
ひとりぶたい	一人舞台	独り舞台
ひとりひとり	一人一人
ひとりずもう	独り相撲
ひとりずまい	一人住まい
ひとりしばい	一人芝居
ひとりしずみ	一人沈み
ひとりしずか	一人静
ひとりぐらし	独り暮し	独り暮らし	一人暮し	一人暮らし
ひとりくらい	一人位
ひとりがてん	独り合点
ひとりあるき	一人歩き	独り歩き
ひとりあたり	一人当
ひとりあたま	一人頭
ひとりあそび	一人遊び
ひとめいわく	人迷惑
ひとみごくう	人身御供
ひとまちがお	人待ち顔
ひとふでがき	一筆書き	一筆書
ひとはたらき	一働き
ひとはこぶん	一箱分
ひとでぶそく	人手不足
ひとつぶより	一粒選り
ひとつぶだね	一粒種
ひとつぶえり	一粒選り
ひとつひとつ	１つひとつ	一つ一つ
ひとつきほど	一月程
ひとつきぶん	一月分
ひとつきはん	一月半
ひとつおぼえ	一つ覚え
ひとっぱしり	ひとっ走り	一っ走り
ひとだんらく	一段落
ひとそうどう	一騒動
ひとぜんたい	人全体
ひとぜんいん	人全員
ひとすじなわ	一筋縄
ひとしょうぶ	一勝負
ひとざいさん	一財産
ひとさわがせ	人騒がせ
ひとさしゆび	人指し指	人差し指	人差指
ひとこきゅう	一呼吸
ひとくちだい	一口大
ひとがんばり	一頑張り
ひとかたまり	一塊
ひとえまぶた	一重瞼
ひとえばおり	単羽織
ひとえきぶん	一駅分
ひとうじこく	非当時国
ひとうけつろ	非凍結路
ひといちばい	人一倍
ひといじょう	人以上
ひとあんしん	一安心
ひとあしらい	人あしらい
ひていじょう	非定常
ひていきてき	非定期的
ひていいけん	否定意見
ひづけよやく	日付予約
ひづけじゅん	日付順
ひつようぶん	必要分
ひつようなし	必要無
ひつようせい	必要性
ひつようがく	必要額
ひつようあく	必要悪
ひつどくしょ	必読書
ひつぜんてき	必然的
ひつぜんせい	必然性
ひつじゅひん	必需品
ひっぷひっぷ	匹夫匹婦
ひっときょく	ヒット曲
ひっとうしゃ	筆頭者
ひっすじこう	必須事項
ひっさつわざ	必殺技
ひっさいぼん	筆彩本
ひっこしづか	引越疲
ひっこしだい	引越し代
ひっこしさき	引越先
ひっけいぼん	必携本
ひっくりかえ	ひっくり返	引っくり返
ひっきようぐ	筆記用具
ひっきしけん	筆記試験
ひっかききず	引っ掻き傷
ひちょっこう	非直交
ひちょくせん	非直線
ひちゃくよう	非着用
ひちくじょう	肥畜場
ひだりようそ	左要素
ひだりめよう	左目用
ひだりまわり	左回り
ひだりぼたん	左ボタン
ひだりぶんき	左分岐
ひだりぶぶん	左部分
ひだりどなり	左隣
ひだりてまえ	左手前
ひだりてくび	左手首
ひだりていち	左手位置
ひだりだせき	左打席
ひだりだしゃ	左打者
ひだりぜんぶ	左前部
ひだりさいき	左再帰
ひだりかっこ	左括弧	『
ひだりうしろ	左後
ひだたかやま	飛騨高山
ひだかちほう	日高地方
ひたんちょう	非単調
ひたちのみや	常陸宮
ひたちにこう	日立二高
ひたちせいき	日立精機
ひたちじょし	日立女子
ひたちこうき	日立工機
ひたちかせい	日立化成
ひたちおおた	常陸太田
ひたいしょう	非対称
ひそうちゃく	非装着
ひぜんかしま	肥前鹿島
ひせんもんか	非専門家
ひせっしょく	非接触
ひせいしょく	非生殖
ひせいきぐん	非正規軍
ひずみりょう	歪量
ひじりがおか	聖ヶ丘
ひじょうよう	非常用
ひじょうほう	秘情報
ひじょうべる	非常ベル
ひじょうとう	非常灯
ひじょうせん	非常線
ひじょうすう	被乗数
ひじょうしき	非常識
ひじょうぐち	非常口
ひじょうきん	非常勤
ひじゅんせい	非純正
ひじゅんしょ	批准書
ひじゅんこく	批准国
ひじゅんきょ	非準拠
ひじゅうふく	非重複
ひじめいかい	非自明解
ひじでっぽう	肘鉄砲
ひじせいたい	非磁性体
ひじこうげき	肘攻撃
ひしんしゅう	非侵襲
ひしょしょう	秘書省
ひしょくしゃ	被食者
ひしょくけい	比色計
ひしょうよう	非商用
ひしょうてん	被昇天
ひしょうたい	飛翔体
ひしょうしゃ	非照射
ひしょうしつ	非晶質
ひしょうざめ	飛翔鮫
ひしょうぐん	飛将軍
ひしゅりゅう	非主流
ひしゅうたん	非終端
ひしはいしゃ	被支配者
ひざかんせつ	膝関節
ひさべつしゃ	被差別者
ひさかたぶり	久方振	久方振り
ひごたのうら	肥後田浦
ひごぎんこう	肥後銀行
ひごかんせい	非互換性
ひごうりてき	非合理的
ひこのじょう	彦之丞
ひこねひがし	彦根東
ひこねしりつ	彦根市立
ひこしまぐち	彦島口
ひこさぶろう	彦三郎
ひこくなかま	被告仲間
ひこうちゅう	飛行中
ひこうちいき	飛行地域
ひこうじょう	飛行場
ひこうじかん	飛行時間
ひこうしれい	飛行指令
ひこうこうど	飛行高度
ひこうきろく	飛行記録
ひこうきょり	飛行距離
ひこうきない	飛行機内
ひこうきだい	飛行機台	飛行機代
ひこうきじこ	飛行機事故
ひこうきぐも	飛行機雲
ひこうかいぶ	非公開部
ひげんしょう	非減少
ひげんごてき	非言語的
ひげんぎょう	非現業
ひけっていし	非決定子
ひけっしょう	非結晶
ひぐんじてき	非軍事的
ひくどうがわ	非駆動側
ひきわけすう	引分数
ひきょくしょ	非局所
ひきょうゆう	非共有
ひきょうもの	卑怯者
ひきょうかい	非境界
ひきゅうめん	非球面
ひきゅうせん	飛球線
ひきのばしき	引伸機
ひきとりにん	引取人
ひきとりさき	引取先
ひきつぎひん	引き継ぎ品
ひきだししき	引出式
ひきたてやく	引立て役	引き立て役
ひきずりまわ	引き摺り回	引きずり回
ひきすういち	引数位置
ひきごうてき	非記号的
ひきこもごも	悲喜交々
ひきこみせん	引込み線	引き込み線	引込線
ひきかえけん	引き換え券	引換券	引替券
ひきうけにん	引受人
ひきあてきん	引当金
ひきあげせん	引上線
ひがしりしり	東利尻
ひがしよしの	東吉野
ひがしやまと	東大和
ひがしやまこ	東山湖
ひがしふしみ	東伏見
ひがしのしろ	東能代
ひがしにほん	東日本
ひがしなるせ	東成瀬
ひがしなりた	東成田
ひがしなだく	東灘区
ひがしなかの	東中野
ひがしなかす	東中州
ひがしどうり	東通
ひがしとなみ	東礪波	東砺波
ひがしとつか	東戸塚
ひがしでぐち	東出口
ひがしつがる	東津軽
ひがしちょう	東町
ひがしちちぶ	東秩父
ひがしちくま	東筑摩
ひがしたがわ	東田川
ひがしそのぎ	東彼杵
ひがしせふり	東背振
ひがししいじ	東椎路
ひがしこうべ	東神戸
ひがしくるめ	東久留米
ひがしくびき	東頚城
ひがしくしろ	東釧路
ひがしぎんざ	東銀座
ひがしかぐら	東神楽
ひがしおおじ	東大路
ひがしおうめ	東青梅
ひがしうすき	東臼杵
ひがしいわい	東磐井
ひがしいちき	東市来
ひがしいずも	東出雲
ひがしいずみ	東和泉
ひがしいこま	東生駒
ひがくしゅう	非学習
ひがいとどけ	被害届
ひがいいしき	被害意識
ひかんじもじ	非漢字文字
ひかんじばん	非漢字版
ひかんじけん	非漢字圏
ひかるげんじ	光源氏
ひかりどけい	光時計
ひかりでんち	光電池
ひかりたんし	光端子
ひかりそうさ	光走査
ひかりしげき	光刺激
ひかりがおか	光が丘
ひかりかがや	光り輝
ひかめいこく	非加盟国
ひかぜいわく	非課税枠
ひかげぶぶん	日陰部分
ひかくひょう	比較表
ひかくしげき	比較刺激
ひかくけっか	比較結果
ひかくきゅう	比較級
ひかくかのう	比較可能
ひかくいけん	比較意見
ひかくあいて	比較相手
ひかがくてき	非科学的
ひかがくしょ	非科学書
ひかかんぐん	非可換群
ひかかいせい	非可解性
ひえだのあれ	稗田阿礼
ひえたいしゃ	日吉大社
ひえじんじゃ	日枝神社
ひえいりせい	非営利性
ひえいごけん	非英語圏
ひいんじもじ	非印字文字
ひいんがてき	非因果的
ひいんがせい	非因果性
ひいらいしゃ	被依頼者
ひいきりきし	贔屓力士
ひあっしゅく	非圧縮
はんろんしゃ	反論者
はんろんがわ	反論側
はんれいほう	判例法
はんりゅうし	反粒子
はんらんざい	反乱罪
はんらんぐん	叛乱軍	反乱軍
はんようひん	汎用品
はんようばん	汎用版
はんようてき	汎用的
はんようせい	汎用性
はんもんてん	板門店
はんみっしつ	半密室
はんぽてまえ	半歩手前
はんべつほう	判別法
はんべつしき	判別式
はんぷくほう	反復法
はんぷくてき	反復的
はんぶんすう	繁分数
はんぶんさぎ	半分詐欺
はんぶんいか	半分以下
はんぶっしつ	反物質
はんぱつてき	反発的
はんぱちょう	半波長
はんばいよう	販売用
はんばいもと	販売元
はんばいもう	販売網
はんばいまえ	販売前
はんばいぶん	販売分
はんばいひん	販売品
はんばいてん	販売店
はんばいだか	販売高
はんばいすう	販売数
はんばいじょ	販売所
はんばいじき	販売時期
はんばいしゃ	販売者
はんばいさき	販売先
はんばいけん	販売権
はんばいかい	販売会
はんばいいん	販売員
はんはちょう	半波長
はんのうりつ	反応率
はんのうせい	反応性
はんのうしき	反応式
はんにんやく	犯人役
はんにんまえ	半人前
はんにんたち	犯人達
はんにんぞう	犯人像
はんにんがわ	犯人側
はんにゅうぶ	搬入部
はんにゅうび	搬入日
はんにゃとう	般若湯
はんにちけん	半日券
はんにちかん	半日間
はんにじゅう	半二重
はんなんだい	阪南大
はんなどうろ	阪奈道路
はんながぐつ	半長靴
はんどうてき	反動的
はんどうたい	半導体
はんどうせい	半同棲
はんとしまえ	半年前
はんとしぶん	半年分
はんとしちか	半年近
はんとしごと	半年毎
はんとしかん	半年間
はんとうめい	半透明
はんとうまく	半透膜
はんでんせい	班田制
はんてんもじ	反転文字
はんていめい	判定名
はんていほう	判定法
はんていぶん	判定文
はんていこう	半抵抗
はんていいん	判定員
はんつきまい	半搗き米
はんちしょう	半致傷
はんだんてん	判断点
はんだしみん	半田市民
はんだくてん	゜	半濁点
はんだくおん	半濁音
はんだいせい	阪大生
はんだいこう	阪大工
はんたいろん	反対論
はんたいせつ	反対説
はんたいせい	反体制
はんたいすう	反対数
はんたいしゃ	反対者
はんたいぎし	反対岸
はんたいきじ	反対記事
はんたいがわ	反対側
はんぞうもん	半蔵門
はんそくわざ	反則技
はんそくよう	販促用
はんそくぶつ	販促物
はんそくきん	反則金
はんそうよう	搬送用
はんせんでも	反戦デモ
はんせんけい	半線形
はんせいぶん	反省文
はんせいひん	半製品
はんせいてん	反省点
はんせいかい	反省会
はんすういか	半数以下
はんじょうき	繁盛記
はんじどうか	半自動化
はんしんろん	汎神論	汎心論
はんしんよく	半身浴
はんしんのだ	阪神野田
はんしんちく	阪神地区
はんしんせん	阪神戦
はんしんがわ	阪神側
はんしんかん	阪神間
はんしょくば	繁殖馬
はんしょくち	繁殖地
はんしょくじ	繁殖時
はんしゃりつ	反射率	反射律
はんしゃめん	反射面
はんしゃばん	反射板
はんしゃてん	反射点
はんしゃてき	反射的
はんしゃたい	反射体
はんしゃぞう	半写像
はんしゃそく	反射則	反射束
はんしゃせい	反射性
はんしゃしき	反射式
はんしゃざい	反射材
はんしゃこう	反射光
はんしゃけい	反射系
はんしゃがた	反射型
はんしゃかく	反射角
はんしゃかい	反社会
はんしゃおん	反射音
はんざいれき	犯罪歴
はんざいりつ	犯罪率
はんざいとし	犯罪都市
はんざいてき	犯罪的
はんざいせい	犯罪性
はんざいしゃ	犯罪者
はんごんたん	反魂丹
はんごんこう	反魂香
はんこうてき	反抗的
はんこうたく	半光沢
はんこうえい	半公営
はんげんぱつ	反原発
はんげつばん	半月板
はんげっぽう	半月報
はんげきそち	反撃措置
はんけつぶん	判決文
はんけつしょ	判決書
はんくうかん	半空間
はんぎょじん	半魚人
はんぎゃくじ	反逆児
はんきちすう	半吉数
はんがじてん	版画事典
はんがくぶん	半額分
はんがくせつ	半楽節
はんがくけん	半額券
はんがくけい	半額系
はんがくいか	半額以下
はんかんせい	半完成
はんかんすう	汎関数
はんかちょう	犯科帳
はんかこけい	半過去形
はんかくもじ	半角文字
はんかくめい	反革命
はんかくぶん	半角分
はんかくかな	半角仮名	半角カナ
はんかいてん	半回転
はんおんした	半音下
はんおんかい	半音階
はんおうこく	藩王国
はんえんけい	攀縁茎
はんえいてき	反映的
はんうちゅう	反宇宙
はんいんよう	半陰陽
はんいしてい	範囲指定
はれんちざい	破廉恥罪
はるらんまん	春爛漫
はるみふとう	晴海埠頭
はるいちばん	春一番
はりまのくに	播磨国
はりのむしろ	針の筵
はりちりょう	針治療
はりせんぼん	針千本
はりしょうが	針生姜
はりさきじこ	針先事故
はりこうかん	針交換
はらんぶくみ	波乱含み
はらてっけつ	爬羅剔抉
はらだきわこ	原田貴和子
はらたつのり	原辰徳
はらしょぼう	原書房
はらごしらえ	腹拵え
はらいもどし	払い戻し	払戻	払戻し
はらいっぱい	腹一杯
はやりやまい	流行病
はやりすたり	流行り廃り
はやみひょう	早見表
はやまちょう	葉山町
はやてまわし	早手回し
はやしらざん	林羅山
はやしたつお	林達夫
はやしことば	囃子詞
はやかわこう	早川港
はやいものが	早い者勝
はまりきゅう	浜離宮
はまみやせん	浜宮線
はままつばん	浜松版
はままつにし	浜松西
はままつてん	浜松店
はままつだこ	浜松凧
はままつしぶ	浜松支部
はままつきち	浜松基地
はままつかん	浜松間
はままつえき	浜松駅
はまとんべつ	浜頓別
はまがくえん	浜学園
はまかわさき	浜川崎
はぶたえもち	羽二重餅
はばゆうせん	幅優先
はばつじんじ	派閥人事
ははおややく	母親役
ははおやたち	母親達
ははおやがわ	母親側
はねっかえり	跳ねっ返り
はなればなれ	離れ離れ
はなれこじま	離れ小島
はなみょうが	花茗荷
はなみずがわ	花水川
はなのみやこ	花の都
はなぬすびと	花盗人
はなでんしゃ	花電車
はなっぱしら	鼻っ柱
はなちるさと	花散里
はなたかだか	鼻高々
はなしんじゅ	花真珠
はなしょうぶ	花菖蒲
はなしちゅう	話中	話し中
はなしじたい	話自体
はなしことば	話言葉	話し言葉
はなしいぜん	話以前
はなしあいて	話し相手	話相手
はなさきせん	花咲線
はなこうぼう	花工房
はなうらない	花占い
はつわちょう	発話長
はつわじしん	発話自身
はつらいにち	初来日
はつやくまん	初役満
はつものぐい	初物食い
はつめいひん	発明品
はつめいしゃ	発明者
はつめいおう	発明王
はつばいわく	発売枠
はつばいもと	発売元
はつばいまえ	発売前
はつばいぶん	発売分
はつばいびご	発売日後
はつばいづき	発売月
はつばいつき	発売月
はつばいずみ	発売済
はつばいすう	発売数
はつばいじょ	発売所
はつばいじき	発売時期
はつばいしゃ	発売者
はつばいがく	発売額
はつばいえき	発売駅
はつねつたい	発熱体
はつとうばん	初登板	初投板
はつとうさい	初搭載
はつとうこう	初投稿
はつでんよう	発電用
はつでんしょ	発電所
はつだいえき	初台駅
はつたいせん	初対戦
はつたいけん	初体験
はつたいけつ	初対決
はつそうこう	初走行
はつせんぱつ	初先発
はつせいたい	初聖体
はつずりぶん	初刷分
はつじょうき	発情期
はつしょうり	初勝利
はつしゅつば	初出馬
はつしゅえん	初主演
はつさんせん	初参戦
はつさいよう	初採用
はつこうはん	初公判
はつこうかい	初公開
はつげんしゃ	発言者
はつげんけん	発言権
はつくろぼし	初黒星
はつがんせい	発癌性
はつがぼうし	発芽防止
はつかんぷう	初完封
はつかんとう	初完投
はつかんそう	初完走
はつかんせん	初観戦	初感染
はつかんせつ	初冠雪
はつかねずみ	二十日鼠
はつかいごう	初会合
はつおんびん	撥音便
はつおんたい	発音体
はつおんすう	発音数
はつおんしゃ	発音者
はつおんけい	発音系
はつえんとう	発炎筒	発煙筒	発煙灯
はつえきけん	発駅券
はついくがく	発育学
はつあんしゃ	発案者
はっぽうもく	八方目
はっぽうせつ	発砲説
はっぽうせい	発泡性
はっぽうしゅ	発泡酒
はっぽうざい	発泡剤
はっぽうさい	八宝菜
はっぽうおん	発砲音
はっぽうおね	八方尾根
はっぽうえん	八芳園
はっぴょうび	発表日
はっぴょうじ	発表時
はっぴょうご	発表後
はっとうしん	八等身	八頭身
はってんてき	発展的
はってんせい	発展性
はってんけい	発展形	発展型
はっちゃくち	発着地
はっそうよう	発送用
はっそうまえ	発走前
はっそうほう	発送法	発想法
はっそうぶつ	発送物
はっそうしゃ	発送者
はっそうさき	発送先
はっそうけい	発想系
はっせいりつ	発生率
はっせいもと	発生元
はっせいほう	発声法	発生法
はっせいひん	発生品
はっせいねん	発生年
はっせいてん	発生点
はっせいてき	発生的
はっせいすう	発生数
はっせいじき	発声時期
はっせいしゃ	発声者
はっせいげん	発生源
はっせいがく	発生学
はっすいせい	撥水性
はっすいざい	撥水剤
はっしんよう	発信用
はっしんもと	発信元
はっしんにん	発信人
はっしんしゃ	発信者
はっしんさき	発信先
はっしんげん	発信源
はっしんがわ	発信側
はっしんおん	発振音	発信音
はっしょうち	発祥地
はっしょうご	発症後
はっしゃまえ	発車前
はっしゃだい	発射台
はっしゃこう	発射口
はっしゃかん	発射管
はっしゃおん	発射音
はっこうもと	発行元
はっこうぶつ	発行物
はっこうねん	発行年
はっこうにん	発行人
はっこうたい	発光体
はっこうせん	八高線
はっこうすう	発行数
はっこうじょ	発行所
はっこうじき	発行時期
はっこうしょ	発行所
はっこうしゅ	発酵酒
はっこうしゃ	発行者
はっけんばん	白鍵盤
はっけんねん	発見年
はっけんでん	八犬伝
はっけんてき	発見的
はっけんしゃ	発見者
はっけんいち	発見位置
はっけいじま	八景島
はっけいおき	八景沖
はっきょうし	発狂死
はっかひんど	発火頻度
はっかかのう	発火可能
はっかいしき	発会式
はっかいさん	八海山
はちろうがた	八郎潟
はちょうごと	波長毎
はちゅうるい	爬虫類	爬蟲類
はちゃめちゃ	葉茶目茶
はちめんたい	八面体
はちまんやま	八幡山
はちまんまち	八幡町
はちまんたい	八幡平
はちまんぐう	八幡宮
はちほんまつ	八本松
はちぶんぎざ	八分儀座
はちぶせやま	鉢伏山
はちぶしゅう	八部衆
はちぶおんぷ	♪	八分音符	８分音符
はちのへせん	八戸線
はちじゅうに	八十二
はちこうだい	八工大
はちげんすう	八元数
はちおうじし	八王子市
はだかんぼう	裸ん坊
はだかまつり	裸祭	裸祭り
はだかてがた	裸手形
はだかそうば	裸相場
はたんちょう	ハ短調
はたんきょう	巴旦杏
はたらきもの	働き者
はたらきばち	働き蜂
はたらきづめ	働き詰め
はたらきぐち	働き口
はたらきがい	働き甲斐
はたらきあり	働き蟻
はためいわく	傍迷惑
はたしじょう	果たし状	果し状
はたさしもの	旗指物
はたけちがい	畑違い
はせいきそく	派生規則
はずみぐるま	弾み車
はすうしょり	端数処理
はすうきりあ	端数切上
はじょううん	波状雲
はじめまして	始めまして	初めまして
はしりづかい	走り使い
はしらどけい	柱時計
はしらごよみ	柱暦
はしょうふう	破傷風
はしゅつじょ	派出所
はしゅつしょ	派出所	派出署
はしもとてん	橋本店
はしもとえき	橋本駅
はしがみえき	橋上駅
はこはんぶん	箱半分
はこねゆもと	箱根湯本
はこねはちり	箱根八里
はこねとざん	箱根登山
はこねざいく	箱根細工
はこだてやま	函館山
はこだてせん	函館線
はこだてえき	函館駅
はこさきぐう	筥崎宮
はこかなもの	箱金物
はこうぶんぷ	波高分布
はけいほせい	波形補正
はぐるましき	歯車式
はくりたばい	薄利多売
はくらんかい	博覧会
はくらくてん	白楽天
はくらいひん	舶来品
はくようしゃ	白揚社	白洋舎
はくようけん	伯養軒
はくほうどう	博報堂
はくへいせん	白兵戦
はくぶつがく	博物学
はくぶつかん	博物館
はくぶついん	博物院
はくねつとう	白熱灯
はくねつこう	白熱光
はくちょうざ	白鳥座
はくちょうこ	白鳥湖
はくちゅうむ	白昼夢
はくせんしゃ	薄銭社	白泉社
はくせんきん	白癬菌	白鮮菌
はくすいしゃ	白水社
はくじんしゅ	白人種
はくじんけい	白人系
はくじゃくじ	薄弱児
はくしょくか	白色化
はくしかてい	博士課程
はくしいにん	白紙委任
はくさんした	白山下
はくげきほう	迫撃砲
はくがいしゃ	迫害者
はくいすがた	白衣姿
はきだしまど	掃出し窓	掃き出し窓
はきさしもど	破棄差戻
はがしょぼう	芳賀書房
はがしょてん	芳賀書店
はかますがた	袴姿
はかたみなみ	博多南
はかたいがい	博多以外
はかせかてい	博士課程
はかいりょく	破壊力
はかいむざん	破戒無慙
はかいこうい	破壊行為
はかいけんさ	破壊検査
はおんきごう	ハ音記号
はいれつめい	配列名
はいれつない	配列内
はいれつすう	配列数
はいれつけい	配列型
はいゆうたち	俳優達
はいぼくしゃ	敗北者
はいぶんしゃ	配分者
はいぶんがく	配分額
はいふばしょ	配布場所
はいふはんい	配布範囲
はいふじゆう	配布自由
はいふきんし	配布禁止
はいふきょひ	配布拒否
はいふきてい	配布規定
はいふかのう	配布可能
はいばんほう	胚盤胞
はいはんざい	背叛罪
はいにんざい	背任罪
はいとくしゃ	背徳者
はいとうれい	廃刀令
はいとうりつ	配当率
はいとうぶん	配当分
はいとうきん	配当金
はいでんばん	配電盤
はいてくかぶ	ハイテク株
はいちじょう	配置上
はいちいぜん	配置以前
はいたつまえ	配達前
はいたつにん	配達人
はいたつじこ	配達事故
はいたつしゃ	配達者
はいたついん	配達員
はいそうよう	配送用
はいそうさき	配送先
はいそうけい	配送系
はいぜんしつ	配膳室
はいせんまえ	敗戦前
はいせんすう	敗戦数
はいせんしき	廃線敷
はいせんこく	敗戦国
はいせんあと	廃線跡
はいせつぶつ	排泄物
はいずりまわ	這いずり回
はいすいよう	排水用
はいすいせい	排水性
はいすいしゅ	肺水腫
はいすいこう	排水溝	排水口
はいすいかん	排水管	配水管
はいじょろん	排除論
はいじません	拝島線
はいじまかん	拝島間
はいじまえき	拝島駅
はいじつせい	背日性
はいしょうき	排障器
はいしゃたい	廃車体
はいしまぎわ	廃止間際
はいこうせい	配光性
はいけっかく	肺結核
はいけいせい	胚形成
はいけいこう	背景光
はいけいおん	背景音
はいぐうたい	配偶体
はいぐうしゃ	配偶者
はいきりょう	排気量
はいきひんど	廃棄頻度
はいきひよう	廃棄費用
はいききせい	排気規制
はいかんめい	配管名
はいかんごう	廃刊号
はいかきょう	拝火教
はいいんぼん	排印本
はいいろぐま	灰色熊
ほんるいだおう	本塁打王
ほんりゅういき	本流域
ほんやくちゅう	翻訳中
ほんやくじょう	翻訳上
ほんやくきかく	翻訳規格
ほんやかんけい	本屋関係
ほんもくちょう	本牧町
ほんみょうおな	本名同
ほんほうそうじ	本放送時
ほんぺんちゅう	本編中
ほんぶんりゃく	本文略
ほんぶんちゅう	本文中
ほんぶんかかい	本分科会
ほんぶこうない	本部構内
ほんぶこうしゃ	本部校舎
ほんひょうしき	本標識
ほんばんちゅう	本番中
ほんはっぴょう	本発表
ほんねんどぶん	本年度分
ほんにんどうし	本人同士
ほんにんしだい	本人次第
ほんにんいがい	本人以外
ほんどほうめん	本土方面
ほんどけっせん	本土決戰	本土決戦
ほんとくしゅう	本特集
ほんだなせいり	本棚整理
ほんだかついち	本多勝一
ほんたいないぶ	本体内部
ほんたいこうぶ	本体後部
ほんたいきばん	本体基盤
ほんたいかかく	本体価格
ほんたいいしき	本体意識
ほんたいいがい	本体以外
ほんせんじょう	本線上
ほんじょうほう	本情報
ほんじょうぞう	本醸造
ほんじょうこう	本条項
ほんじゅつしき	本術式
ほんじつよなか	本日夜中
ほんじつちゅう	本日中
ほんしんさかい	本審査会
ほんしれんさい	本誌連載
ほんしょまつび	本書末尾
ほんしょうきん	本賞金
ほんしゅうせい	本修正
ほんしゅうじん	本州人
ほんしゅうがわ	本州側
ほんしゅいしょ	本趣意書
ほんしゃきんむ	本社勤務
ほんしゃきのう	本社機能
ほんしけいさい	本誌掲載
ほんしかきょう	本四架橋
ほんごくしよう	本国仕様
ほんごうどおり	本郷通り
ほんこんぶたい	香港部隊
ほんこんえいが	香港映画
ほんけんきゅう	本研究
ほんけほんもと	本家本元
ほんかくすいり	本格推理
ほんかくさんか	本格参加
ほんいいんかい	本委員会
ほんあつぎかん	本厚木間
ほろよいきげん	微酔い機嫌
ほろほろちょう	珠鶏
ほりゅうじこう	保留事項
ほりゅうじかん	保留時間
ほゆうねんすう	保有年数
ほふくぜんしん	匍匐前進
ほっぴょうよう	北氷洋
ほっそくとうじ	発足当時
ほっそくいらい	発足以来
ほっきょくてん	北極点
ほっきょくせい	北極星
ほっきょくけん	北極圏
ほっきょくぐま	北極熊
ほっきょくかん	北極冠
ほっきょくかい	北極海
ほっきせつりつ	発起設立
ほっかいゆでん	北海油田
ほっかいどうご	北海道語
ほっかいえんぎ	法界縁起
ほちょうちょう	ホ長調
ほちょうしょり	補聴処理
ほちょうこうか	補聴効果
ほちょうかいろ	補聴回路
ほだかおんせん	穂高温泉
ほたるのひかり	蛍の光
ほたかじんじゃ	穂高神社
ほぞんほうほう	保存方法
ほぞんじっせき	保存実績
ほぞんけいたい	保存形態
ほぞんけいしき	保存形式
ほぞんうんどう	保存運動
ほそよこちょう	細横町
ほそくていせい	補足訂正
ほそくせつめい	補足説明
ほそくじっけん	補足実験
ほそくしりょう	補足資料
ほぜんしょぶん	保全処分
ほせんさぎょう	保線作業
ほせいとくせい	補正特性
ほせいしゅだん	補正手段
ほせいけいすう	補正係数
ほせいかじょう	補正過剰	補性過剰
ほじょれっしゃ	補助列車
ほじょへんすう	補助変数
ほじょじっけん	補助実験
ほじょしんごう	補助信号
ほじょしつもん	補助質問
ほじょきんがく	補助金額
ほじょかんすう	補助関数
ほしょくちゅう	補食中
ほしょうほけん	補償保険
ほしょうせいど	補償制度	保証制度
ほしょうしょり	補償処理
ほしょうさいむ	保証債務
ほしょうきげん	保証期限
ほしょうきかん	保証期間
ほしょうかのう	保証可能
ほしょうかいろ	補償回路
ほしゅようしゃ	保守用車
ほしゅてんけん	保守点検
ほしゅたいおう	保守対応
ほしゅさぎょう	保守作業
ほしゅけいやく	保守契約
ほしゅおうこく	保守王国
ほしゅうぶひん	補修部品
ほしひょうめん	星表面
ほしのおんせん	星野温泉
ほしとりひょう	星取表
ほごようでんち	保護用電池
ほごのうりょく	保護能力
ほこりたいさく	埃対策
ほこうしゃよう	歩行者用
ほこうきつえん	歩行喫煙
ほげいもんだい	捕鯨問題
ほけんやっかん	保険約款
ほけんたいいく	保健体育
ほけんけいやく	保険契約
ほけんきんがく	保険金額
ほけんがいしゃ	保険会社
ほけんえいせい	保健衛生
ほけんいりょう	保険医療
ほけつせんきょ	補欠選挙
ほくりょなんわ	北虜南倭
ほくべいしよう	北米仕様
ほくべいいがい	北米以外
ほくぶほうめん	北部方面
ほくとしちせい	北斗七星
ほくそうちいき	北総地域
ほくおうしんわ	北欧神話
ほくえつせいし	北越製紙
ほきゅうりょう	補給量
ほきゅうぶっし	補給物資
ほかんわりあい	補間割合
ほかんれっしゃ	補完列車
ほかんほうほう	補間方法
ほかんせってい	補間設定
ほかんくうこう	補完空港
ほかんかいすう	補間回数
ほおんせいのう	保温性能
ほうれいしゅう	法令集
ほうりろんてき	法理論的
ほうりゅうぎょ	放流魚
ほうりつようご	法律用語
ほうりつふじょ	法律扶助
ほうりつせいど	法律制度
ほうりつじょう	法律上
ほうりつじほう	法律時報
ほうりつじしん	法律自身
ほうりつこうい	法律行為
ほうりつぎけつ	法律議決
ほうりついはん	法律違反
ほうらくのけい	炮烙之刑
ほうようりょく	包容力
ほうもんちゅう	訪問中
ほうもんきゃく	訪問客
ほうもんかのう	訪問可能
ほうめいちょう	芳名帳
ほうむだいじん	法務大臣
ほうぼくちゅう	放牧中
ほうほんはんし	報本反始
ほうほうじたい	方法自体
ほうほういがい	方法以外
ほうべいちゅう	訪米中
ほうへいきゅう	宝瓶宮
ほうふくこうい	報復行為
ほうひほんせん	豊肥本線
ほうねんせいゆ	豊年製油
ほうねつこうか	放熱効果
ほうにんしゅぎ	放任主義
ほうなんちょう	方南町
ほうどうぶもん	報道部門
ほうどうしせい	報道姿勢
ほうどうきょく	報道局
ほうどうきせい	報道規制
ほうどうきかん	報道機関
ほうでんきのう	放電機能
ほうでんかこう	放電加工
ほうてきせいり	法的整理
ほうてきけんり	法的権利
ほうてきけんち	法的見地
ほうてききせい	法的規制
ほうていりりつ	法定利率
ほうていりそく	法定利息
ほうていひよう	法定費用
ほうていだいり	法定代理
ほうていそくど	法定速度
ほうていきかん	法定期間
ほうていかじつ	法定果実
ほうちしんぶん	報知新聞
ほうちしゃかい	法治社会
ほうそくじょう	法則上
ほうそうろくが	放送録画
ほうそうよてい	放送予定
ほうそうようご	放送用語
ほうそうみてい	放送未定
ほうそうにちじ	放送日時
ほうそうとうじ	放送当時
ほうそうでんぱ	放送電波
ほうそうちゅう	放送中
ほうそうせつび	放送設備
ほうそうせいど	放送制度
ほうそうじゅん	放送順
ほうそうじこく	放送時刻
ほうそうじかん	放送時間
ほうそうしょう	放送賞
ほうそうさっか	放送作家
ほうそうきんし	放送禁止
ほうそうきょく	放送局
ほうそうきょう	放送響
ほうそうきざい	放送機材
ほうそうかいし	放送開始
ほうそういがい	放送以外
ほうせきしょう	宝石商
ほうせいにこう	法政二高
ほうせいどがい	法制度外
ほうせいきょく	法制局
ほうしょくひん	宝飾品
ほうしょうめい	褒賞名
ほうしょうきん	報償金	報奨金
ほうしゅつめん	放出面
ほうしゃりょう	放射量
ほうしゃそしき	放射組織
ほうしゃせんか	放射線科
ほうしゃじょう	放射状
ほうしちょうだ	封豕長蛇
ほうしきちがい	方式違い
ほうしきじょう	方式上
ほうしきしゅぎ	方式主義
ほうしかつどう	奉仕活動
ほうこくひょう	報告票
ほうこくじこう	報告事項
ほうこくしゅう	報告集
ほうこうべつか	方向別化
ほうこうていい	方向定位
ほうこうせんそ	方向線素
ほうこうしゅう	芳香臭
ほうこうしじき	方向指示機	方向指示器
ほうこうこてい	方向固定
ほうこうおんち	方向音痴
ほうこういどう	方向移動
ほうこうあわせ	方向合わせ
ほうげんのらん	保元の乱
ほうけんじだい	封建時代
ほうきょうにん	奉教人
ほうきかんれい	法規慣例
ほうがんびいき	判官贔屓
ほうがくちがい	方角違い
ほうかんじょう	法感情
ほうかんしょう	宝冠章
ほうかつせいど	包括制度
ほうかついぞう	包括遺贈
ほうかしきえん	蜂窩織炎
ほうかいりんき	法界悋気
ほうかいしゃく	法解釈
ほうおうちょう	法王庁
ほうえきのほう	縫腋の袍
ほうえいわすう	放映話数
ほうえいりょう	放映料
ほうえいにちじ	放映日時
ほうえいとうじ	放映当時
ほうえいちゅう	放映中
ほうえいちいき	放映地域
ほうえいじゅん	放映順
ほうえいじかん	放映時間
ほうえいきんし	放映禁止
ほうえいきかん	放映期間
ほういかいぼう	法医解剖
ほあんよういん	保安要員
ほあんしょぶん	保安処分
ほあんしゅにん	保安主任
ほあんきじゅん	保安基準
へんむけいやく	片務契約
へんふくちょう	変復調
へんぴんかのう	返品可能
へんにゅうせい	編入生
へんにゅうがく	編入学
へんどうりょう	変動量
へんどうちゅう	変動中
へんどうそうば	変動相場
へんどうきんり	変動金利
へんどうえがら	変動絵柄
へんちょうおん	変調音
へんたいやろう	変態野郎
へんたいこうい	変態行為
へんそくちゅう	変速中
へんそくそうさ	変速操作
へんそくきのう	変速機能
へんそくきこう	変速機構
へんそうりょう	返送料
へんそうけっか	返送結果
へんそうきょく	変奏曲
へんそうきのう	返送機能
へんそうきげん	返送期限
へんせいひょう	編成表
へんせいちょう	編成長
へんせいちゅう	編成中
へんせいたんい	編成単位
へんせいぜんぶ	編成全部
へんすうひょう	変数表
へんすうていぎ	変数定義
へんすうきごう	変数記号
へんしんちゅう	変身中
へんしんきのう	変身機能
へんしゅうよう	編集用
へんしゅうもの	編集物
へんしゅうまえ	編集前
へんしゅうばん	編集盤
へんしゅうにん	編集人
へんしゅうずみ	編集済
へんしゅうしゃ	編集者	編輯者
へんしゅうしつ	編集室
へんしゅうけん	編集権
へんしゅうがわ	編集側
へんしゅうかい	編集会
へんしゅういん	編集員
へんしゅういと	編集意図
へんしゃちゅう	編者注
へんしつきょう	偏執狂
へんこうりれき	変更履歴
へんこうりょう	変更量
へんこうようし	変更用紙
へんこうぶぶん	変更部分
へんこうふのう	変更不能
へんこうとどけ	変更届
へんこうちゅう	変更中
へんこうそうさ	偏向走査
へんこうじゆう	変更自由
へんこうくかん	変更区間
へんこうかのう	変更可能
へんこうかしょ	変更箇所
へんこういらい	変更依頼
へんげんせきご	片言隻語
へんけいじざい	変形自在
へんくつやろう	偏屈野郎
へんきょくばん	編曲版
へんきょくてん	変曲点
へんきょくしゃ	編曲者
へんかんぶぶん	変換部分
へんかんふのう	変換不能
へんかんひょう	変換表
へんかんちゅう	変換中
へんかんたんい	変換単位
へんかんそくど	変換速度
へんかんそうち	変換装置
へんかんそうさ	変換操作
へんかんせいど	変換精度
へんかんじしょ	変換辞書
へんかんこうほ	変換候補
へんかんけっか	変換結果
へんかんぎょう	変換行
へんかんきのう	変換機能
へんかんきそく	変換規則
へんかんかのう	変換可能
へんかんかてい	変換過程
へんいせいぶん	変位成分
へちょうちょう	ヘ長調
へくとりっとる	竡
へくとめーとる	粨
へいわこうえん	平和公園
へいわけんぽう	平和憲法
へいわいじぐん	平和維持軍
へいろんりしき	閉論理式
へいれつろんり	並列論理
へいれつもでる	並列モデル
へいれつましん	並列マシン
へいれつどうさ	並列動作
へいれつしょり	並列処理
へいれつげんご	並列言語
へいれつきでん	並列饋電
へいれつきこう	並列機構
へいれつきおく	並列記憶
へいりょくてき	兵力的
へいりょういき	閉領域
へいりつじょし	並立助詞
へいようきょう	併用橋
へいめんずけい	平面図形
へいめんじょう	平面上	平面状
へいめんこうさ	平面交差
へいめんきょう	平面鏡
へいのうぶんり	兵農分離
へいてんまぎわ	閉店間際
へいてんちゅう	閉店中
へいそうじかん	並走時間
へいせいちょう	平成町
へいせいいしん	平成維新
へいじょうしん	平常心
へいじつしんや	平日深夜
へいしゅうごう	閉集合
へいこうみゃく	平行脈
へいこうぶんぷ	平衡分布
へいこうどうさ	並行動作
へいこうしんか	並行進化	平行進化
へいこうしょり	並行処理
へいこうくかん	並行区間
へいこういどう	平行移動
へいきんりゅう	平均流
へいきんひよう	平均費用
へいきんちょう	平均長
へいきんそくど	平均速度
へいきんじそく	平均時速
へいきんきょり	平均距離
へいきんきおん	平均気温
へいきんかぶか	平均株価
へいきょくめん	閉曲面
へいきょくせん	閉曲線
へいきばいばい	兵器売買
へいきせいぎょ	兵器制御
へいかんまぎわ	閉館間際
へいかつかぶん	平滑化分
へいかつかいろ	平滑回路
へいあんちょう	平安朝
へいあんじだい	平安時代
へいあんきょう	平安京
ふんりゅうしき	噴流式
ふんべつざかり	分別盛り
ふんどしすがた	褌姿
ふんそうちいき	紛争地域
ふんじんきせい	粉塵規制
ふんしゅつおん	噴出音
ふんしゃりょう	噴射量
ふんしつとどけ	紛失届
ふんしつきゅう	紛失球
ふんかさいがい	噴火災害
ふろくほんたい	付録本体
ふろくいっさつ	付録一冊
ふろうしょとく	不労所得
ふれんぞくてん	不連続点
ふれんぞくてき	不連続的
ふれんぞくせん	不連続線
ふれんぞくせい	不連続性
ふれんけつせい	不連結性
ふるほんやがい	古本屋街
ふるにょうぼう	古女房
ふるじゅうでん	フル充電
ふるかわでんち	古河電池
ふるかわちょう	古川町
ふりょくくどう	浮力駆動
ふりょうせくた	不良セクタ
ふりょうざいこ	不良在庫
ふりょうかりつ	不良化率
ふりょうかしょ	不良箇所
ふりゅうもんじ	不立文字
ふりつだいがく	府立大学
ふりつこうこう	府立高校
ふりだしきょく	振出局
ふりそですがた	振袖姿
ふりこれっしゃ	振子列車
ふりこみようし	振込用紙
ふりこでんしゃ	振子電車
ふりかえゆそう	振替輸送
ふりかえひょう	振替票
ふらのこくどう	富良野国道
ふようふくしゃ	不要輻射
ふようふきゅう	不要不急
ふようしんぞく	扶養親族
ふようこうじょ	扶養控除
ふようかきゅう	扶養加給
ふゆものがたり	冬物語
ふゆしょうぐん	冬将軍
ふゆがっしゅく	冬合宿
ふゆうたいりく	浮遊大陸
ふめんひょうき	譜面表記
ふめんいんさつ	譜面印刷
ふみんふきゅう	不眠不休
ふみこみだたみ	踏込畳
ふほうたいざい	不法滞在
ふほうかんきん	不法監禁
ふほうかいぞう	不法改造
ふへんろんそう	普遍論争
ふへんほうそく	普遍法則
ふへんぶんさん	不偏分散
ふへいこうかん	不平衡間
ふぶんけんぽう	不文憲法
ふふつせんそう	普仏戦争
ふばんたいけい	付番体系
ふばいうんどう	不買運動
ふにんちりょう	不妊治療
ふにんききしゅ	不人気機種
ふなばしつうか	船橋通過
ふどうにょざん	不動如山
ふどうとくしゃ	不道徳者
ふところぐあい	懐具合
ふところがたな	懐刀
ふとうれんばい	不当廉売
ふとうめいかん	不透明感
ふとうひょうじ	不当表示
ふとうはんけつ	不当判決
ふとうしょぶん	不当処分
ふていのやから	不逞の輩
ふていせきぶん	不定積分
ふていしゅうそ	不定愁訴
ふつかれんぞく	二日連続
ふつうれっしゃ	普通列車
ふつうゆうびん	普通郵便
ふつうめんきょ	普通免許
ふつうほうじん	普通法人
ふつうでんしゃ	普通電車
ふつうだんたい	普通団体
ふつうせんきょ	普通選挙
ふつうおおがた	普通大型
ふつううんよう	普通運用
ふつううんちん	普通運賃
ふっこしんとう	復古神道
ふっこうきょう	腹腔鏡
ふっきゅうしゃ	復旧車
ふっきほうほう	復帰方法
ふっきしょせん	復帰初戦
ふちんせんかん	不沈戦艦
ふちょうきかん	不調期間
ふちゅうしみん	府中市民
ふたんほうほう	負担方法
ふたんけいしき	負担形式
ふたりいじょう	二人以上
ふたむかしまえ	二昔前
ふたまたみゃく	二又脈
ふたまたぶんし	二又分枝
ふたまたじょう	二又状
ふたばこうこう	雙葉高校
ふたごやまべや	二子山部屋
ふたごやまぜい	二子山勢
ふたごたまがわ	二子多摩川	二子玉川
ふたことみこと	二言三言
ふたこたまがわ	二子玉川
ふぞくへんせい	附属編成	付属編成
ふぞくひんめい	付属品名
ふぞくひんとも	付属品共
ふぞくごじしょ	附属語辞書	付属語辞書
ふぞくこうこう	附属高校	付属高校
ふせいほんのう	父性本能
ふせいじつせい	不誠実性
ふせいかくせい	不正確性
ふせいかいぞう	不正改造
ふじんだんたい	婦人団体
ふじんけいかん	婦人警官
ふじわらきょう	藤原京
ふじよしだがわ	富士吉田側
ふじよしだえき	富士吉田駅
ふじょぼうこう	婦女暴行
ふじょうりょく	浮上力
ふじょうりげき	不条理劇
ふじょうちゅう	浮上中
ふじょうそうち	浮上装置
ふじやまかんび	藤山寛美
ふじみしょぼう	富士見書房
ふじみこうこう	富士見高校
ふじつうあいち	富士通愛知
ふじたかんこう	藤田観光
ふじぜろっくす	富士ゼロックス
ふじじゅうこう	富士重工
ふじしゃりょう	富士車輌
ふじさんちょう	富士山頂
ふじさわいこう	藤沢以降
ふじげんがっき	富士弦楽器
ふじきゅうこう	富士急行
ふじえだひがし	藤枝東
ふしんにんあん	不信任案
ふしんじんもん	不審尋問
ふしょうふずい	夫唱婦随
ふしょうちゅう	負傷中
ふしゅつじょう	不出場
ふしみてんのう	伏見天皇
ふしぎえいこく	不思議英国
ふさくいさいむ	不作為債務
ふさいそうがく	負債総額
ふさいごうけい	負債合計
ふごうりいぜん	不合理以前
ふごうかくしゃ	不合格者
ふこころえもの	不心得者
ふこうへいせい	不公平性
ふこうへいかん	不公平感
ふげんじっこう	不言実行
ふけんぜんせい	不健全性
ふけいどうはん	父兄同伴
ふくろのねずみ	袋の鼠
ふくろいりぼん	袋入本
ふくりゅうすい	伏流水
ふくりゅうえん	副流煙
ふくりじちょう	副理事長
ふくりこうせい	福利厚生
ふくようりょう	服用量
ふくようちゅう	服用中
ふくやしょてん	福屋書店
ふくまかいがん	福間海岸
ふくへんそくき	副変速機
ふくぷろぐらむ	副プログラム
ふくびこうえん	副鼻腔炎
ふくはんそうは	副搬送波
ふくちょうじく	復調軸
ふくちょうかん	副長官
ふくちやません	福知山線
ふくちやまかん	福知山間
ふくだんちょう	副団長
ふくだつねあり	福田恆存
ふくだいひょう	副代表
ふくたけぶんこ	福武文庫
ふくそへんすう	複素変数
ふくそへいめん	複素平面
ふくそせきぶん	複素積分
ふくそすうたい	複素数体
ふくそすうがた	複素数型
ふくそかんすう	複素関数
ふくそかいせき	複素解析
ふくせんでんか	複線電化
ふくせんちょう	副船長
ふくせんくかん	複線区間
ふくせいはんが	複製版画
ふくせいいらい	複製依頼
ふくすうりょう	複数両
ふくすうようい	複数用意
ふくすうほゆう	複数保有
ふくすうひょう	複数票
ふくすうねんじ	複数年次
ふくすうどうじ	複数同時
ふくすうどうさ	複数動作
ふくすうそうさ	複数走査
ふくすうしてい	複数指定
ふくすうさんか	複数参加
ふくすうこうほ	複数候補
ふくすうぎょう	複数行
ふくすうきぼう	複数希望
ふくすうきどう	複数起動
ふくすうきしゅ	複数機種
ふくすうかしょ	複数箇所
ふくじんひしつ	副腎皮質
ふくじゅうせん	複縦線
ふくじもんだい	副次問題
ふくしょちょう	副所長	副署長
ふくしょくぶつ	副食物
ふくしょくひん	服飾品
ふくしょうしき	複勝式	復勝式
ふくしょうぐん	副将軍
ふくしゅしょう	副首相
ふくしゅうせん	復讐戦
ふくしゅうしん	復讐心
ふくしゅうげき	復讐劇
ふくしゅうきじ	復習記事
ふくしゃりょう	複写料
ふくしゃちょう	副社長
ふくしゃおんど	輻射温度
ふくしまきょく	福島局
ふくしまきねん	福島記念
ふくしまいらい	福島以来
ふくしねんきん	福祉年金
ふくしだんたい	福祉団体
ふくしぞうしん	福祉増進
ふくしじぎょう	福祉事業
ふくしししゅつ	福祉支出
ふくしこうがく	福祉工学
ふくしかんけい	福祉関係
ふくざつかいき	複雑怪奇
ふくざいりょう	副材料
ふくさようてき	副作用的
ふくごうにんい	複号任意
ふくごうどうし	複合動詞
ふくごうきのう	複合機能
ふくごうおせん	複合汚染
ふくこうだいふ	福工大附
ふくげんりょく	復原力	復元力
ふくげんりょう	副原料
ふくげんそうち	復元装置
ふくげんこうか	復元効果
ふくきょうだい	福教大
ふくきょうざい	副教材
ふくがんいがい	複眼以外
ふくがくちょう	副学長
ふくかんりにん	副管理人
ふくかんきょう	複環境
ふくかいちょう	副会長
ふくおかばしょ	福岡場所
ふくおかちゃく	福岡着
ふくおかちさい	福岡地裁
ふくおかしみん	福岡市民
ふくおかしない	福岡市内
ふくいほうそう	福井放送
ふくいだいがく	福井大学
ふくいたいかい	福井大会
ふくいくうこう	福井空港
ふくいぎんこう	福井銀行
ふぎょうじょう	不行状
ふきょうわおん	不協和音
ふきゅうどあい	普及度合
ふきゅういいん	普及委員
ふきそしょぶん	不起訴処分
ふきそくぶぶん	不規則部分
ふきそくどうし	不規則動詞
ふかんぜんばん	不完全版
ふかんぜんせい	不完全性
ふかんぜんさく	不完全作
ふかようりょう	負荷容量
ふかじょうほう	負荷情報	付加情報
ふかしょくみん	不可触民
ふかさんめいし	不可算名詞
ふかこうりょく	不可抗力
ふかくていせい	不確定性
ふかくじつせい	不確実性
ふかくじつかん	不確実感
ふかぎゃくてき	不可逆的
ふかぎゃくせい	不可逆性
ふかきんせいど	賦課金制度
ふかがわしゃこ	深川車庫
ふかかいじけん	不可解事件
ふおうせんそう	普墺戦争
ふぉるてぴあの	forte piano
ふぉるてっしも	fortessimo
ふえふきどうじ	笛吹童子
ふぇざーきゅう	フェザー級
ふうろそうもく	フウロソウ目	Geraniales
ふうろそうぞく	フウロソウ属
ふうりんかざん	風林火山
ふうりょくけい	風力計
ふうりゅうじん	風流人
ふうまにんじゃ	風魔忍者
ふうふべっせい	夫婦別姓
ふうふそうほう	夫婦双方
ふうふせいかつ	夫婦生活
ふうふけいたい	夫婦形態
ふうふかんけい	夫婦関係
ふうにゅうしき	封入式
ふうにゅうざい	封入材
ふうぞくようご	風俗用語
ふうぞくじょう	風俗嬢
ふうぞくぎょう	風俗業
ふうささくせん	封鎖作戦
ふうこうめいび	風光明媚
ふうからいでん	風火雷電
ふううんきゅう	風雲急
ふういんじょう	封印城
ふいふいきょう	回回教
ふぃんらんどご	フィンランド語
ふぃりぴんかい	フィリピン海
ふあんていせい	不安定性
ふあんていかい	不安定解
ひんぴょうかい	品評会
ひんばにかんば	牝馬二冠馬
ひんせいげれつ	品性下劣
ひんずーきょう	ヒンズー教
ひんしぶんかい	品詞分解
ひんしつじょう	品質上
ひんしつきかく	品質規格
ひんしつかんり	品質管理
ひわりけいさん	日割計算
ひろはばとびら	広幅扉
ひろだいそうか	広大総科
ひろしまひがし	広島東
ひろしまなづけ	広島菜漬
ひろしまちょう	広島町
ひろしまちほう	広島地方
ひろしましない	広島市内
ひろしましだい	広島市大
ひろしまししゃ	広島支社
ひろしましがい	広島市街
ひろしまいがい	広島以外
ひろさきじょう	弘前城
ひろうこんぱい	疲労困憊
ひろうこっせつ	疲労骨折
ひろうかいふく	疲労回復	疲勞恢復
ひれんぞくてき	非連続的
ひれいぼうしゃ	非冷房車
ひれいはいぶん	比例配分
ひれいていすう	比例定数
ひれいかんけい	比例関係
ひるむしろもく	ヒルムシロ目	Potamogetonales
ひらまくりきし	平幕力士
ひらのじんじゃ	平野神社
ひらつかしない	平塚市内
ひらつかしがい	平塚市街
ひらたあつたね	平田篤胤
ひらがなこもじ	平仮名小文字
ひらがげんない	平賀源内
ひらかたしみん	枚方市民
ひらかたしえき	枚方市駅
ひよりみしゅぎ	日和見主義
ひょうろんしゃ	評論社
ひょうろうぜめ	兵糧攻め
ひょうりゅうき	漂流記
ひょうめんてき	表面的
ひょうめんせき	表面積
ひょうめいしゃ	表明者
ひょうめいけん	表明権
ひょうほんびん	標本瓶
ひょうほんてん	標本点
ひょうほんすう	標本数
ひょうばんわる	評判悪
ひょうばんどお	評判通
ひょうばんごう	表番号
ひょうはくざい	漂白剤
ひょうてきかく	標的核
ひょうだいらん	表題欄
ひょうだいさく	表題作
ひょうそうてき	表層的
ひょうじようそ	表示要素
ひょうじゅんち	標準値
ひょうじゅんじ	標準時
ひょうじゅんご	標準語
ひょうじゅんき	標準軌	標準機
ひょうじゅんか	標準課	標準化
ひょうじぶぶん	表示部分
ひょうじはんい	表示範囲
ひょうじちゅう	表示中
ひょうじそくど	表示速度
ひょうじそうち	表示装置
ひょうじじょう	表示上
ひょうじじかん	表示時間
ひょうじしょく	表示色
ひょうじぎょう	表示行
ひょうじきのう	表示機能
ひょうじきかく	表示規格
ひょうじがめん	表示画面
ひょうじかのう	表示可能
ひょうじかかく	表示価格
ひょうしきとう	標識灯
ひょうさくさん	氷酢酸
ひょうごりょう	兵庫寮
ひょうげんろん	表現論
ひょうげんよく	表現欲
ひょうげんほう	表現法
ひょうげんない	表現内
ひょうげんてき	表現的
ひょうげんしゃ	表現者
ひょうげんしき	表現式
ひょうげんけい	表現系	表現型
ひょうけんさく	表検索
ひょうけつけん	表決権
ひょうけいしき	表形式
ひょうけいさん	表計算
ひょうきんもの	剽軽者
ひょうきじょう	表記上
ひょうがじょう	氷河上
ひょうがじだい	氷河時代
ひょうかりょう	評価量
ひょうかふのう	評価不能
ひょうかせいど	評価制度
ひょうかししん	評価指針
ひょうかしけん	評価試験
ひょうかしえん	評価支援
ひょうかけっか	評価結果
ひょうかぎほう	評価技法
ひょうかきそく	評価規則
ひょうかかかく	評価価格
ひょうかいがい	評価以外
ひょうおんもじ	表音文字
ひょうおんぶん	表音文
ひょうおんてき	表音的
ひょうおんせい	表音性
ひょういきのう	表意機能
ひゆひょうげん	比喩表現
ひやしちゅうか	冷し中華
ひゃっきやこう	百鬼夜行
ひゃっかじてん	百科事典	百科辞典
ひゃくれんぱつ	百連発
ひゃくようばこ	百葉箱
ひゃくめんそう	百面相
ひゃくめいざん	百名山
ひゃくみだんす	百味箪笥
ひゃくまんべん	百万遍
ひゃくまんねん	百万年
ひゃくまんにん	百万人
ひゃくまんだら	百万陀羅
ひゃくまんだい	百万台
ひゃくまんごく	百万石
ひゃくまんかい	百万回
ひゃくまんえん	百万円
ひゃくぶんりつ	百分率
ひゃくねんまえ	百年前
ひゃくにんりき	百人力
ひゃくにんぎり	百人斬り
ひゃくにちそう	百日草
ひゃくにちぜき	百日咳
ひゃくどまいり	百度参り
ひゃくしょうよ	百姓読
ひゃくえんだま	百円玉
ひめじほうめん	姫路方面
ひみんしゅてき	非民主的
ひみんしゅせい	非民主性
ひみつたんてい	秘密探偵
ひみつたいいん	秘密隊員
ひみつげんしゅ	秘密厳守
ひみつけっしゃ	秘密結社
ひみつかいだん	秘密会談
ひまつでんせん	飛沫伝染
ひまつかんせん	飛沫感染
ひほんしつてき	非本質的
ひほうしゃせい	非放射性
ひへいそくせい	非閉塞性
ひへいこうけい	非平衡系
ひぶんめいてき	非文明的
ひぶんさんせい	非分散性
ひぶそうちたい	非武装地帯
ひふんこうがい	悲憤慷慨
ひびやせんない	日比谷線内
ひびやこくさい	日比谷国際
ひびやこうえん	日比谷公園
ひひょうじゅん	非標準
ひばくしゃほご	被爆者保護
ひはんせいしん	批判精神
ひはかいけんさ	非破壊検査
ひのじどうしゃ	日野自動車
ひのうりつてき	非能率的
ひにんげんてき	非人間的
ひなんくんれん	避難訓練
ひなんかんこく	避難勧告
ひなにんぎょう	雛人形	ひな人形
ひどうとくてき	非道徳的
ひどうきどうさ	非同期動作
ひどうきしょり	非同期処理
ひとりせんよう	一人専用
ひとりじかんさ	一人時間差
ひとりいっさつ	一人一殺
ひとりいちだい	一人一台
ひとりいじょう	一人以上
ひともんちゃく	一悶着
ひとむかしまえ	一昔前
ひとばんじゅう	一晩中
ひとつばしだい	一橋大
ひとつきいない	一月以内
ひとせだいまえ	一世代前
ひとかたならず	一方ならず
ひとうひょうば	被投票馬
ひとあしちがい	一足違い
ひでんこうかい	秘伝公開
ひでんかろせん	非電化路線
ひでんかせんく	非電化線区
ひでんかくかん	非電化区間
ひてんしゅうさ	非点収差
ひてんけいかく	飛天計劃
ひてつきんぞく	非鉄金属
ひていてきいみ	否定的意味
ひづけしょしき	日付書式
ひつようりょう	必要量
ひつようようし	必要用紙
ひつようぶぶん	必要部分
ひつようぶすう	必要部数
ひつようじょう	必要上
ひつようじこう	必要事項
ひつようげんど	必要限度
ひつようけいひ	必要経費
ひっちょうもの	必聴物
ひっちょうばん	必聴盤
ひっすこうもく	必須項目
ひっしょうぼん	必勝本
ひっしょうほう	必勝法
ひっこみじあん	引っ込み思案
ひだりやじるし	左矢印	←
ひだりみぎはし	左右端
ひだりまえあし	左前足	左前脚
ひだりほうこう	左方向
ひだりふともも	左太股
ひだりはんめん	左半面
ひだりはんぶん	左半分
ひだりはんどる	左ハンドル
ひだりとうしゅ	左投手
ひだりてんかい	左転回
ひだりてこゆび	左手小指
ひだりそくほう	左側方
ひだりぜんりん	左前輪
ひだりぜんぽう	左前方
ひだりしゃせん	左車線
ひだりしたすみ	左下隅
ひだりこうりん	左後輪
ひだりこうほう	左後方
ひだりくりっく	左クリック
ひだりきんぼう	左近傍
ひだりがわはし	左側端
ひだりうえすみ	左上隅
ひだりいっぱい	左一杯
ひだりあごした	左顎下
ひだかがわかん	日高川間
ひたちまくせる	日立マクセル
ひたちとうほく	日立東北
ひたちでんせん	日立電線
ひたちぞうせん	日立造船
ひたちぜんしゃ	日立全社
ひたちけいよう	日立京葉
ひたちきんぞく	日立金属
ひたちきそけん	日立基礎研
ひたちおおたし	常陸太田市
ひたちえいぞう	日立映像
ひたちいちこう	日立一高
ひたいかくこう	非対角項
ひそひそばなし	ひそひそ話
ひそかごうぶつ	砒素化合物
ひそうぞくにん	被相続人
ひぜんやまぐち	肥前山口
ひせんとういん	非戦闘員
ひせんけいてき	非線形的
ひせんけいせい	非線形性	非線型性
ひせんけいけい	非線型系
ひせんきょけん	被選挙権
ひせつどうてき	非摂動的
ひせつどうこう	非摂動項
ひせつぞくしゃ	被接続者
ひせいふそしき	非政府組織
ひせいさんてき	非生産的
ひせいぎょもじ	非制御文字
ひじんどうてき	非人道的
ひじりばしぐち	聖橋口
ひじょうじよう	非常時用
ひじょうじたい	非常事態
ひじょうしょく	非常食
ひじゅうふくわ	非重複和
ひじどうかけん	非自動化券
ひじつりょくは	非実力派
ひじつようてき	非実用的
ひじつようせい	非実用性
ひじちょうもく	飛耳長目
ひしょうじけん	非訟事件
ひしゅりゅうは	非主流派
ひしゅうきてき	非周期的
ひしゃかいてき	非社会的
ひしつもんしゃ	被質問者
ひししょくぶつ	被子植物
ひしきゅうすう	被死球数
ひざしたていど	膝下程度
ひさべつぶらく	被差別部落
ひさべついしき	被差別意識
ひさくてきがわ	被索敵側
ひさいべんさい	非債弁済
ひこてんろんり	非古典論理
ひこうりつてき	非効率的
ひこうぶったい	飛行物体
ひこうせんこく	非交戦国
ひこうせいてき	非構成的
ひこうこうばん	飛行甲板
ひこうけんにん	被後見人
ひげんじつてき	非現実的
ひげんじつせい	非現実性
ひけんせつてき	非建設的
ひけつほうほう	否決方法
ひけっていろん	非決定論
ひけっていてき	非決定的
ひけっていせい	非決定性
ひけいそくしゃ	被計測者
ひけいしきてき	非形式的
ひけいざいてき	非経済的
ひけいけんしゃ	非経験者
ひぐんじそしき	非軍事組織
ひぐちいちよう	樋口一葉
ひくうはくもじ	非空白文字
ひきんえんしゃ	非禁煙車
ひきめかぎはな	引目鉤鼻
ひきつえんしゃ	非喫煙者
ひきごうしょり	非記号処理
ひきかえしょう	引換証
ひがないちにち	日がな一日
ひがしわかやま	東和歌山
ひがしよどがわ	東淀川
ひがしやまなし	東山梨
ひがしやまとし	東大和市
ひがしやません	東山線
ひがしやつしろ	東八代
ひがしもろかた	東諸県
ひがしめいはん	東名阪
ひがしむろらん	東室蘭
ひがしむらやま	東村山
ひがしまつやま	東松山
ひがしまつうら	東松浦
ひがしまいづる	東舞鶴
ひがしべついん	東別院
ひがしひろしま	東広島
ひがしはんぶん	東半分
ひがしはんのう	東飯能
ひがしなかやま	東中山
ひがしたてやま	東館山
ひがしせきわけ	東関脇
ひがしすみよし	東住吉
ひがししりいけ	東尻池
ひがししらかわ	東白川
ひがししずおか	東静岡
ひがししおじり	東塩尻
ひがしこむすび	東小結
ひがしこがねい	東小金井
ひがしこうえん	東公園
ひがしぐちてん	東口店
ひがしくにさき	東国東
ひがしきりゅう	東桐生
ひがしきたざわ	東北沢
ひがしかんばら	東蒲原
ひがしかんとう	東関東
ひがしかわぐち	東川口
ひがしかながわ	東神奈川
ひがしかつしか	東葛飾
ひがしかすがい	東春日井
ひがしかいがん	東海岸
ひがしおかざき	東岡崎
ひがしおおたに	東大谷
ひがしおおさか	東大阪
ひがしいややま	東祖谷山
ひがしいばらき	東茨城
ひがしいせざき	東伊勢崎
ひがしあわくら	東粟倉
ひがしあおやま	東青山
ひがしあおもり	東青森
ひがいもうそう	被害妄想
ひがいはっせい	被害発生
ひがいたいおう	被害対応
ひがいじんだい	被害甚大
ひがいしんせい	被害申請
ひがいしんこく	被害申告
ひがいしゃほご	被害者保護
ひがいきんがく	被害金額
ひかんりさいと	非管理サイト
ひかんせいけい	非慣性系
ひかんじぶぶん	非漢字部分
ひかんさいじん	非関西人
ひかわじんじゃ	火川神社	氷川神社
ひかりはんのう	光反応
ひかりはつでん	光発電
ひかりつうしん	光通信
ひかりしんごう	光信号
ひかりこうがく	光工学
ひかりこうかん	光交換
ひかりぎょうこ	光凝固
ひかりぎじゅつ	光技術
ひかりかんれん	光関連
ひかりかいせん	光回線
ひかちゅうしゃ	皮下注射
ひかさんむげん	非加算無限	非可算無限
ひかくはんだん	比較判断
ひかくじっけん	比較実験
ひかくしちょう	比較視聴
ひかくけんとう	比較検討
ひかくかんすう	比較関数
ひかがくぶんや	非科学分野
ひかえせんしゅ	控え選手
ひかいいんあて	非会員宛
ひえんざんすう	被演算数
ひえいりりよう	非営利利用
ひえいりそしき	非営利組織
ひあっしゅくじ	非圧縮時
はんわせんない	阪和線内
はんれいしゅう	判例集
はんらんぶんし	反乱分子
はんようきよう	汎用機用
はんもうしょう	半盲症
はんめいしだい	判明次第
はんべつかのう	判別可能
はんぷくきごう	反復記号
はんぶんほんき	半分本気
はんぶんていど	半分程度
はんぶんぜんご	半分前後
はんぶんじゃく	半分弱
はんぶんしゅみ	半分趣味
はんぶんししん	半分私信
はんぶんくらい	半分位
はんびょうにん	半病人
はんぱつりょく	反発力
はんぱつさよう	反発作用
はんばいりょう	販売量
はんばいりえき	販売利益
はんばいぶもん	販売部門
はんばいばしょ	販売場所
はんばいちゅう	販売中
はんばいたんい	販売単位
はんばいそしき	販売組織
はんばいじょう	販売場
はんばいけいろ	販売経路
はんばいきんし	販売禁止
はんばいきかん	販売期間
はんばいかんり	販売管理
はんばいかかく	販売価格
はんばいかいし	販売開始
はんばいあいて	販売相手
はんのうそくど	反応速度
はんのうじかん	反応時間
はんのうきこう	反応機構
はんにゅうこう	搬入口
はんにちていど	半日程度
はんどくようい	判読容易
はんどくふのう	判読不能
はんどうしそう	反動思想
はんとりちょう	判取帳
はんとしていど	半年程度
はんとししよう	半年使用
はんとしけいか	半年経過
はんとしくらい	半年位
はんとしいない	半年以内
はんとけいまき	反時計巻
はんてんどうさ	反転動作
はんてんじかん	反転時間
はんていぶぶん	判定部分
はんていふのう	判定不能
はんていけっか	判定結果
はんていきのう	判定機能
はんていかのう	判定可能
はんていかいろ	判定回路
はんちょくせん	半直線
はんちょうおん	半長音
はんちゅうめい	範疇名
はんちゅうがい	範疇外
はんだんりょく	判断力
はんだんようそ	判断要素
はんだんけっか	判断結果
はんだんかのう	判断可能
はんだふりょう	半田不良
はんだいりぶつ	阪大理物
はんだいじんか	阪大人科
はんたいりゆう	反対理由
はんたいひょう	反対票
はんたいたすう	反対多数
はんたいせいは	反体制派
はんたいしんか	反対進化
はんたいしょく	反対色
はんたいしょう	反対称
はんたいいけん	反対意見
はんそくこうい	反則行為
はんそくきっぷ	反則切符
はんそうちゅう	帆走中
はんせんもけい	帆船模型
はんせんびょう	ハンセン病
はんせんどうし	帆船同士
はんせんしそう	反戦思想
はんせんえいが	反戦映画
はんせいいでん	伴性遺伝
はんじゅんじょ	半順序
はんじどうてき	半自動的
はんじつかそう	反実仮想
はんじせいこう	反磁性項
はんしんふずい	半身不随	半身付随
はんしんはんぎ	半信半疑
はんしんちほう	阪神地方
はんしんじだい	阪神時代
はんしんしせん	阪神支線
はんしゃせいど	反射精度
はんしゃしょく	反射色
はんしゃけいろ	反射経路
はんしゃきょう	反射鏡
はんざいぼうし	犯罪防止
はんざいそしき	犯罪組織
はんざいそうさ	犯罪捜査
はんざいこうい	犯罪行為
はんざいげんば	犯罪現場
はんざいきろく	犯罪記録
はんこてんろん	半古典論
はんこっかてき	反国家的
はんこうげんば	犯行現場
はんげつじょう	半月状
はんげきじょう	半劇場
はんげきかいし	反撃開始
はんけつりゆう	判決理由
はんぎゃくしゃ	反逆者
はんきょうらん	半狂乱
はんきょうばん	反響板
はんきょうせい	半強制
はんきょうしん	反共振
はんきょうおん	反響音
はんきゅうはい	阪急杯
はんきゅうたい	半球体
はんきゅうせん	阪急線
はんきゃくしき	半脚式
はんがくていど	半額程度
はんがくくらい	半額位
はんかくすうじ	半角数字
はんかくきごう	半角記号
はんおんいない	半音以内
はんえいちゅう	半影中
はんえいきゅう	半永久
はんいぶんせき	範囲分析
はんいせんたく	範囲選択
はるがっしゅく	春合宿
はるあきれんぱ	春秋連覇
はらじゅくてん	原宿店
はらじゅくちか	原宿地下
はらじゅくえき	原宿駅
はやねはやおき	早寝早起き
はやくちことば	早口言葉
はやくちえいご	早口英語
はやかわぶんこ	早川文庫
はやかわでんき	早川電気
はやいものがち	早い者勝ち
はもんせんこく	破門宣告
はめんごうせい	波面合成
はままつちょう	浜松町
はままつじょう	浜松城
はままつしない	浜松市内
はままついだい	浜松医大
はまだしょうご	浜田省吾
はまさかちほう	浜坂地方
はまぐちちょう	浜口町
はまぐちおさち	浜口雄幸
はまおおつえき	浜大津駅
はぼたんしょう	葉牡丹賞
はばつあらそい	派閥争い
ははおやゆらい	母親由来
ははおやいがい	母親以外
はねだくうこう	羽田空港
はにゅうのやど	埴生の宿
はなわほきいち	塙保己一
はなびたいかい	花火大会
はなひゃっけい	花百景
はなせんじょう	鼻洗浄
はなしはんぶん	話半分
はなしじょうず	話し上手	話上手
はなさかじじい	花咲爺
はなうりむすめ	花売娘
はないちもんめ	花一匁
はどうせいぶん	波動成分
はどうかんすう	波動関数
はとやまちょう	鳩山町
はつわないよう	発話内容
はつれいちゅう	発令中
はつゆうしょう	初優勝
はつほんるいだ	初本塁打
はつびょうりつ	発病率
はつばいよてい	発売予定
はつばいみてい	発売未定
はつばいぶすう	発売部数
はつばいびまえ	発売日前
はつばいひづけ	発売日付
はつばいとうじ	発売当時
はつばいちゅう	発売中
はつばいぜんご	発売前後
はつばいじゅん	発売順
はつばいじこく	発売時刻
はつばいじかん	発売時間
はつばいきんし	発売禁止
はつばいきねん	発売記念
はつばいきかん	発売期間
はつばいがっぴ	発売月日
はつばいかいし	発売開始
はつばいえんき	発売延期
はつねつりょう	発熱量
はつねつちゅう	発熱中
はつどうちゅう	発動中
はつとうじょう	初登場
はつでんりょう	発電量
はつでんせつび	発電設備
はつでんしせつ	発電施設
はつでんげんり	発電原理
はつちょうせん	初挑戦
はつだいひょう	初代表
はつじゅしょう	初受賞
はつしんしゅつ	初進出
はつしゅっぱん	初出版
はつしゅってい	初出艇
はつしゅっそう	初出走
はつしゅっきん	初出勤
はつこうぎょう	初興業	初興行
はつげんりょく	発言力
はつげんりょう	発現量
はつげんちゅう	発言中
はつげんがっき	撥弦楽器
はつがげんまい	発芽玄米
はつかおあわせ	初顔合わせ	初顔合せ
はつおんぶぶん	発音部分
はつおんふめい	発音不明
はつおんふごう	発音符合
はつおんじょう	発音上
はつおんしゅぎ	発音主義
はつおんきごう	発音記号
はつおんきこう	発音機構
はついくじょう	発育上
はっぽうびじん	八方美人
はっぽうじけん	発砲事件
はっぴょうもう	発表申
はっぴょうまえ	発表前
はっぴょうねん	発表年
はっぴょうずみ	発表済
はっぴょうじき	発表時期
はっぴょうしゃ	発表者
はっぴょうさき	発表先
はっぴょうきじ	発表記事
はっぴょうかい	発表会
はってんけいい	発展経緯
はっちょうみそ	八丁味噌
はっちょうぼり	八丁堀
はっちゅうぬし	発注主
はっちゅうずみ	発注済
はっちゅうしゃ	発注者
はっちゅうがく	発注額
はっちゃくわく	発着枠
はっちゃくびん	発着便
はっちゃくてん	発着点
はっちゃくすう	発着数
はっちゃくじょ	発着所
はっちゃくしん	発着信
はったんにしき	八反錦
はったつしんり	発達心理
はっそうりょう	発送料
はっそうよてい	発送予定
はっそうじたい	発想自体
はっそうしょり	発送処理
はっそうしえん	発想支援
はっそうきぼう	発送希望
はっそうあいず	発走合図
はっせいりょう	発生量
はっせいりゆう	発生理由
はっせいぶんか	発生分化
はっせいひんど	発生頻度
はっせいばしょ	発生場所
はっせいねんど	発生年度
はっせいとうじ	発生当時
はっせいじゅん	発生順
はっせいじこく	発生時刻
はっせいじかん	発声時間
はっせいしゅぎ	発生主義
はっせいくかん	発声区間
はっせいきこう	発声機構
はっせいきげん	発生起源
はっせいきかん	発声器官
はっせいかしょ	発生箇所
はっせいかいろ	発生回路
はっすいかこう	撥水加工
はっしんぶぶん	発振部分
はっしんふのう	発進不能
はっしんどうさ	発信動作
はっしんていし	発進停止
はっしんちゅう	発信中
はっしんじこく	発信時刻
はっしんきょく	発信局
はっしんかそく	発進加速
はっしんかいろ	発振回路
はっしょくせい	発色性
はっしょくすう	発色数
はっしょくざい	発色剤
はっしょうまえ	発症前
はっしゅひょう	ハッシュ表
はっしゃようび	発車曜日
はっしゃじこく	発車時刻
はっしゃじかん	発車時間
はっしゃかくど	発射角度
はっさんていり	発散定理
はっこつしたい	白骨死体
はっこうりょう	発行量	発光量
はっこうぶすう	発行部数
はっこうねんど	発行年度
はっこうださん	八甲田山
はっこうじかん	発光時間
はっこうしゅう	発酵臭
はっこうきかん	発行機関
はっこうかかく	発行価格
はっこういちう	八紘一宇
はっけんちてん	発券地点
はっけんじこく	発券時刻	発見時刻
はっけんかがく	発見科学
はっけんいこう	発見以降
はっけつびょう	白血病
はっけっきゅう	白血球
はっくつけっか	発掘結果
はちょうちょう	ハ長調
はちょうせんい	波長遷移
はちめんろっぴ	八面六臂
はちにんていど	八人程度
はちだいしゅう	八代集
はちじょうじま	八丈島
はちじょうぐち	八条口
はちおうじせん	八王子線
はちおうじがわ	八王子側
はちおうじかん	八王子間
はたらきざかり	働き盛り
はたもとやっこ	旗本奴
はたのていしゃ	秦野停車
はたのえきまえ	秦野駅前
はすのはぎりか	ハスノハギリ科	Hernandiaceae
はすぬまちょう	蓮沼町
はしりはばとび	走り幅跳び
はしぼそがらす	嘴細鴉
はしぶとがらす	嘴太鴉
はしばひでよし	羽柴秀吉
はさんせんこく	破産宣告
はさんすんぜん	破産寸前
はさんざいだん	破産財団
はさんさいけん	破産債権
はこねほうめん	箱根方面
はこねしんどう	箱根新道
はこねえきでん	箱根駅伝
はこだてどっく	函館ドック
はこだてしがい	函館市街
はこだてきねん	函館記念
はこざきちょう	箱崎町
はけんしゃいん	派遣社員
はけんがいしゃ	派遣会社
はけんあらそい	覇権争い
はけいぶんせき	波形分析
はけいにんしき	波形認識
はけいかいせき	波形解析
はくわぶんがく	白話文学
はくろうびょう	白蝋病
はくりせいそう	剥離清掃
はくりこっせつ	剥離骨折
はくようきゅう	白羊宮
はくほうぶんか	白鳳文化
はくへんせっき	剥片石器
はくばほうめん	白馬方面
はくばのりくら	白馬乗鞍
はくばさんけい	白馬山系
はくばえきまえ	白馬駅前
はくはつちゅん	白發中
はくないしょう	白内障
はくちょうだい	白鳥台
はくちょうごう	白鳥号
はくちゅうこう	白昼光
はくじんしはい	白人支配
はくじょうもの	薄情者
はくしろんぶん	博士論文
はくしょくこう	白色光
はくしとうあん	白紙答案
はくしてっかい	白紙撤回
はくごうしゅぎ	白豪主義
はくあいしゅぎ	博愛主義
はきゅうこうか	波及効果
はきさしもどし	破棄差し戻し	破棄差戻し
はかたほうめん	博多方面
はかたえきわき	博多駅脇
はかせろんぶん	博士論文
はかいこうどう	破壊行動
はかいこうさく	破壊工作
はかいかつどう	破壊活動
はうすさいばい	ハウス栽培
はいようぎゅう	廃用牛
はいめんひこう	背面飛行
はいぼくしゅぎ	敗北主義
はいぶんひょう	配分表
はいぶつりよう	廃物利用
はいふよていび	配布予定日
はいふほうほう	配布方法
はいふちゅうし	配付中止	配布中止
はいふせいげん	配布制限
はいふしりょう	配布資料
はいふしゅだん	配布手段
はいふけいたい	配布形態
はいふえんじょ	配布援助
はいはんちけん	廃藩置県
はいどうみゃく	肺動脈
はいとうそしき	配当組織
はいてんねがい	配転願い	配転願
はいてんけっか	配点結果
はいちょうきん	腓腸筋
はいちゅうりつ	排中律
はいちもんだい	配置問題
はいちてんかん	配置転換
はいたつきろく	配達記録
はいたせいぎょ	排他制御
はいそうりょう	配送料	配送量
はいそうしょり	配送処理
はいそうけいろ	配送経路
はいそうきのう	配送機能
はいそうきこう	配送機構
はいせんひっし	敗戦必至
はいせんちょう	配線長
はいすいりょう	排水量
はいすいのじん	背水乃陣	背水の陣
はいすいしょり	排水処理
はいすいしせつ	排水施設
はいすいこうか	排水効果
はいじゅんかん	肺循環
はいじゅくれい	廃塾令
はいしんつうち	配信通知
はいしんこうい	背信行為
はいしゅつけん	排出権
はいしゃてつづ	廃車手続
はいしゃしょう	廃車証
はいしもんだい	廃止問題
はいしほうほう	廃止方法
はいししんせい	廃止申請
はいしけってい	廃止決定
はいごかんけい	背後関係
はいこうじょう	廃工場
はいけつしょう	敗血症
はいけいちしき	背景知識
はいけいせかい	背景世界
はいけいしょく	背景色
はいきんりょく	背筋力
はいきんしゅぎ	拝金主義
はいきゅうもう	配給網
はいきゅうまい	配給米
はいきゅうけん	配給権
はいきていこう	排気抵抗
はいきたいさく	排気対策
はいきしょぶん	廃棄処分
はいききじゅん	廃機基準
はいがいしゅぎ	排外主義
はいかんりょう	拝観料
はいかんていし	拝観停止
はいかんきゃく	拝観客
はいかつりょう	肺活量
はいかっしょく	灰褐色
はいえきしょり	廃液処理
はいいけつごう	配位結合
ほんりょうはっき	本領発揮
ほんやくさぎょう	翻訳作業
ほんもくほうめん	本牧方面
ほんまつてんとう	本末転倒
ほんほうそうだい	本放送第
ほんばばほうこう	本馬場方向
ほんねんどさいご	本年度最後
ほんないしきょう	本内視鏡
ほんだげきじょう	本多劇場
ほんたいないぞう	本体内蔵
ほんたいこしょう	本体故障
ほんせんもんてん	本専門店
ほんせんそうこう	本線走行
ほんせんけいとう	本線系統
ほんせんうんよう	本線運用
ほんすうせいげん	本数制限
ほんじつはつばい	本日発売
ほんしゅうせいし	本州製紙
ほんしゅういなん	本州以南
ほんしゃべっかん	本社別館
ほんしびさんせん	本四備讃線
ほんごうそうもく	Triuridales	ホンゴウソウ目
ほんこんりょこう	香港旅行
ほんこんおうふく	香港往復
ほんけんさそうち	本検査装置
ほんくげぬまえき	本鵠沼駅
ほんきょちいてん	本拠地移転
ほんきょちいがい	本拠地以外
ほんかくさくひん	本格作品
ほんかくうんよう	本格運用
ほんえんそうかい	本演奏会
ほんいんぼうせん	本因坊戦
ほんあんはんけつ	本案判決
ほんあつぎいせい	本厚木以西
ほんあつぎいえん	本厚木以遠
ほりこしこうこう	堀越高校
ほりかわてんのう	堀河天皇
ほにゅうどうぶつ	哺乳動物
ほつうきょうかい	保通協会
ほっぽうりょうど	北方領土
ほっぽうみんぞく	北方民族
ほっこくしんぶん	北国新聞
ほっこくぎんこう	北國銀行	北国銀行
ほっかいどうてん	北海道展
ほっかいどうじん	北海道人
ほっかいどうしぶ	北海道支部
ほっかいどうさん	北海道産
ほっかいこうこう	北海高校
ほちょうかんすう	補聴関数
ほぞんじょうたい	保存状態
ほそくじょうほう	補足情報
ほぜいこうじょう	保税工場
ほせいへんさほう	補正偏差法
ほすうひょうげん	補数表現
ほじょひょうしき	補助標識
ほじょねんりょう	補助燃料
ほじょじょうけん	補助条件
ほじょきんせいど	補助金制度
ほしょうもんだい	補償問題	保障問題
ほしょうにんてい	保証認定
ほしょうないよう	補償内容	保証内容
ほしょうせんでん	保証宣伝
ほしょうじつげん	補償実現
ほしょうきんがく	補償金額
ほしょうかんすう	補償関数
ほしゅりょうきん	保守料金
ほしずめのまつり	鎮火祭
ほけんりょうりつ	保険料率
ほけんりょうきん	保険料金
ほけんやっきょく	保険薬局
ほけんせいきゅう	保険請求
ほけんしんりょう	保険診療
ほけんしょうひん	保険商品
ほけんしょうけん	保険証券
ほくりくほんせん	北陸本線
ほくりくほうめん	北陸方面
ほくりくほうそう	北陸放送
ほくりくてつどう	北陸鉄道
ほくりくせんたん	北陸先端
ほくりくさんけん	北陸三県
ほくりくぎんこう	北陸銀行
ほくべいほうめん	北米方面
ほくだいすうがく	北大数学
ほくだいおうぶつ	北大応物
ほくたんてつどう	北丹鉄道
ほくそうてつどう	北総鉄道
ほくそうせんない	北総線内
ほくせいほうこう	北西方向
ほくさつほうげん	北薩方言
ほくおうしょこく	北欧諸国
ほくえつほくせん	北越北線
ほくえつぎんこう	北越銀行
ほきょうせんしゅ	補強選手
ほきょうしんごう	補強信号
ほきょうしょうこ	補強証拠
ほきょうけいかく	補強計画
ほきゅうもくてき	補給目的
ほきゅうほうほう	補給方法
ほきゅうしゅだん	補給手段
ほかんじょうたい	保管状態
ほかんきょくせん	補間曲線
ほおんじょうたい	保温状態
ほうわじょうたい	飽和状態
ほうわしぼうさん	飽和脂肪酸
ほうろうわくせい	放浪惑星
ほうりつろんそう	法律論争
ほうりつもんだい	法律問題
ほうりつはんだん	法律判断
ほうりつそうだん	法律相談
ほうりつせいれい	法律政令
ほうりつじむしょ	法律事務所
ほうりつがくしゃ	法律学者
ほうりつかんけい	法律関係
ほうりつかいせい	法律改正
ほうらくのうたげ	炮烙の宴	炮烙之宴
ほうもんはんばい	訪問販売
ほうほうじょせつ	方法序説
ほうぶつうんどう	放物運動
ほうふくぜっとう	抱腹絶倒
ほうふくこうげき	報復攻撃
ほうふくかんぜい	報復関税
ほうねつたいさく	放熱対策
ほうなんこうこう	豊南高校
ほうどうばんぐみ	報道番組
ほうどうせいしん	報道精神
ほうどうしゃしん	報道写真
ほうどうかんせい	報道管制
ほうどうかくしゃ	報道各社
ほうとくがくえん	報徳学園
ほうてきひょうか	法的評価
ほうてきせきにん	法的責任
ほうてきしゅだん	法的手段
ほうてきこんきょ	法的根拠
ほうてきけんげん	法的権限
ほうていとうそう	法廷闘争
ほうていせいさん	法定清算
ほうていしきけい	方程式系
ほうていけつぞく	法定血族
ほうていきじゅん	法定基準
ほうちちゅうしゃ	放置駐車
ほうちじてんしゃ	放置自転車
ほうちしゅぎこく	法治主義国
ほうそうよていび	放送予定日
ほうそうもくろく	放送目録
ほうそうほうしき	放送方式
ほうそうばんぐみ	放送番組
ほうそうないよう	放送内容
ほうそうとうむき	放送塔向
ほうそうとうじつ	放送当日
ほうそうだいがく	放送大学
ほうそうけいたい	放送形態
ほうそうぎじゅつ	放送技術
ほうそうきゅうし	放送休止
ほうそうききてん	放送機器展
ほうそうかんけい	放送関係
ほうそうえいせい	放送衛星
ほうせんほうこう	法線方向
ほうせんべくとる	法線ベクトル
ほうせんがくえん	宝仙学園
ほうせいだいこう	法政大工
ほうせいだいがく	法政大学
ほうじんしょとく	法人所得
ほうじんかいいん	法人会員
ほうじょうちょう	北条町
ほうじょうきたい	胞状奇胎
ほうじゅつちょう	砲術長
ほうしんへんこう	方針変更
ほうしんてんかん	方針転換
ほうしんけってい	方針決定
ほうしょうりゅう	宝生流
ほうしゅつりょう	放出量
ほうしゅつりゆう	放出理由
ほうしゅつかてい	放出過程
ほうしゃとくせい	放射特性
ほうしゃそくてい	放射測定
ほうしゃせんたい	放射線帯
ほうしゃせんげん	放射線源
ほうしゃかんすう	放射関数
ほうしゃかっせい	放射活性
ほうしゃかいへん	放射壊変
ほうしゃかいがく	法社会学
ほうしきへんかん	方式変換
ほうしきぞうせつ	方式増設
ほうしきけんとう	方式検討
ほうさくびんぼう	豊作貧乏
ほうこくぶんしょ	報告文書
ほうこうへんかん	方向変換
ほうこうてんかん	方向転換
ほうこうせいやく	方向制約
ほうこうかんてき	報交換的
ほうこうかんかく	方向感覚
ほうげんぶんがく	方言文学
ほうけんしゃかい	封建社会
ほうけいさいぼう	方形細胞
ほうきさいりょう	法規裁量
ほうがんかんけい	包含関係
ほうかんげきたく	抱関撃柝
ほうかんがいこう	砲艦外交
ほうかつめんきょ	包括免許
ほうかつざいさん	包括財産
ほうかつきょうぎ	包括協議
ほうかいていすう	崩壊定数
ほうかいけいれつ	崩壊系列
ほうえいふっかつ	放映復活
ほうえいちょくご	放映直後
ほうえいちゅうし	放映中止
ほうあんせいりつ	法案成立
ほあんぶぶちょう	保安部部長
ほーていらおゆい	河底撈魚
へんほたんちょう	変ホ短調
へんへたんちょう	変ヘ短調
へんばいけいすう	変倍係数
へんはたんちょう	変ハ短調
へんにゅうしけん	編入試験
へんにゅうしかく	編入資格
へんにたんちょう	変ニ短調
へんどうしょとく	変動所得
へんどうかんすう	偏導関数
へんとたんちょう	変ト短調
へんでんしょない	変電所内
へんちょうそくど	変調速度
へんたいひこうき	編隊飛行機
へんたいちょくご	変態直後
へんたいおんがく	変態音楽
へんそくせいのう	変速性能
へんそくしゃそく	変速車速
へんそうほうしき	返送方式
へんせいへんこう	編成変更
へんせいばんごう	編成番号
へんせいぜんたい	編成全体
へんすうてんかい	変数展開
へんすうつうばん	変数通番
へんすうそくばく	変数束縛
へんすうせんげん	変数宣言
へんすうかんすう	変数関数
へんしゅうぶへん	編集部編
へんしゅうびょう	偏執病
へんしゅうちょう	編集長
へんしゅうちゅう	編集中
へんしゅうそしき	編集組織
へんしゅうせいど	編集精度
へんしゅうじょう	編集上
へんしゅうこうき	編集後記
へんしゅうこうい	編集行為
へんしゅうけっか	編集結果
へんしゅうきょく	編集局
へんしゅうきょう	偏執狂
へんしゅうきのう	編集機能
へんしゅうがめん	編集画面
へんしゅうかのう	編集可能
へんしゅういいん	編集委員
へんこうほうほう	変更方法
へんこうほうどう	偏向報道
へんこうふかのう	変更不可能
へんこうひょうじ	変更表示
へんこうないよう	変更内容
へんこうとくせい	偏光特性
へんこうせいぎょ	変更制御
へんこうしんせい	変更申請
へんこうさぎょう	変更作業
へんけいはんけい	変形半径
へんきょくしょう	編曲賞
へんきょうけいび	辺境警備
へんきゃくじかん	返却時間
へんきゃくきげん	返却期限
へんかんほうほう	変換方法
へんかんほうしき	変換方式
へんかんしゅほう	変換手法
へんかんしっぱい	変換失敗
へんかんこうりつ	変換効率
へんかんこうがく	変換工学
へんかんけいすう	変換係数
へんかんぎじゅつ	変換技術
へんかんかんすう	変換関数
へんかくかつよう	変格活用
へんおんどうぶつ	変温動物
へんいたんちょう	変イ短調
へいわふどうさん	平和不動産
へいわじょうやく	平和条約
へいわじょうこう	平和条項
へいわしゅぎしゃ	平和主義者
へいわきょうてい	平和協定
へいわきねんどう	平和祈念堂
へいろでんりゅう	閉路電流
へいれつほうしき	並列方式
へいれつぶんさん	並列分散
へいれつひょうか	並列評価
へいれつたんさく	並列探索
へいれつすいろん	並列推論
へいれつじっこう	並列実行
へいれつごうせい	並列合成
へいれつこうぶん	並列構文
へいれつけいさん	並列計算
へいりょくしよう	兵力使用
へいめんしゃしん	平面写真
へいめんこうせい	平面構成
へいほうめーとる	平方米
へいほうとくせい	閉包特性
へいほうじょうよ	平方剰余
へいへいぼんぼん	平々凡々	平平凡凡
へいふくさいぼう	平伏細胞
へいのうみぶんり	兵農未分離
へいちきょうそう	平地競走
へいそくぜんせん	閉塞前線
へいぜいてんのう	平城天皇
へいせいふきょう	平成不況
へいせいしょたい	平成書体
へいせいがんねん	平成元年
へいじょうきょう	平城京
へいじつはんにち	平日半日
へいじつじょせい	平日女性
へいしんていとう	平身低頭
へいしんうんどう	並進運動
へいしつかいぞう	閉室改造
へいしきあいさつ	閉式挨拶
へいごうかつどう	併合活動
へいこうゆにゅう	並行輸入
へいこうほうこう	平行方向
へいこうはんのう	平衡反応
へいこうていすう	平衡定数
へいこうせいぎょ	並行制御
へいこうじっこう	並行実行
へいこうこうぶん	並行構文
へいこうけいさん	並行計算
へいこうかんかく	平衡感覚
へいけものがたり	平家物語
へいけつへんせい	併結編成
へいけつさぎょう	併結作業
へいきんひきょり	平均飛距離
へいきんねんれい	平均年齢
へいきんねんぼう	平均年棒
へいきんとくてん	平均得点
へいきんすうまん	平均数万
へいきんじゅんい	平均順位
へいきんじじょう	平均2乗	平均二乗
へいきんしんぷく	平均振幅
へいきんかいすう	平均回数
へいかいあいさつ	閉会挨拶
へいおんひょうき	併音表記
へいあんじんぐう	平安神宮
へいあんこうこう	平安高校
ふんやのやすひで	文屋康秀
ふんやのあさやす	文屋朝康
ふんまつせんざい	粉末洗剤
ふんたいこうがく	粉体工学
ふんじんばくはつ	粉塵爆発
ふんしょこうじゅ	焚書坑儒
ふんこつさいしん	粉骨砕身
ふろうちょうじゅ	不老長寿
ふれんどがくえん	普連土学園
ふるたちいちろう	古舘伊知郎
ふるしゅつじょう	フル出場
ふるかわでんこう	古河電工
ふりょうぶっけん	不良物件
ふりょうさいけん	不良債権
ふりょうかいいん	不良会員
ふりなじょうけん	不利な条件
ふりこみよていび	振込予定日
ふりこみしゃめい	振込者名
ふらんすりょうり	フランス料理
ふらんすかくめい	フランス革命
ふようじょうほう	不用情報
ふようしゃてあて	扶養者手当
ふみきりもんだい	踏切問題
ふみきりたいさく	踏切対策
ふみきりせいぎょ	踏切制御
ふまんすいじゅん	不満水準
ふまんかいしょう	不満解消
ふほうにゅうこく	不法入国
ふほうしんにゅう	不法侵入
ふほうしゅうろう	不法就労
ふほうぎょうしゃ	不法業者
ふべんきょうもの	不勉強者
ふへんてきりろん	普遍的理論
ふはつだんしょり	不発弾処理
ふのうじょうけん	不能条件
ふねようしんしつ	船用寝室
ふなばしていしゃ	船橋停車
ふなはしせいいち	舟橋聖一
ふなにしょうけん	船荷証券
ふないりなかまち	舟入中町
ふどうみょうおう	不動明王
ふどうてんていり	不動点定理
ふどうしょうすう	浮動小数
ふどうさんぶもん	不動産部門
ふどうさんぎょう	不動産業
ふとんかんそうき	布団乾燥機
ふとくようりょう	不得要領
ふとくていわしゃ	不特定話者
ふとくていたすう	不特定多数
ふとうがたきこう	不等型気孔
ふていきれんさい	不定期連載
ふていきひょうじ	不定期表示
ふていきかんこう	不定期刊行
ふつかすいそさん	弗化水素酸
ふつうりょうきん	普通料金
ふつうじょうよう	普通乗用
ふつうじどうしゃ	普通自動車
ふつうしゃしよう	普通車使用
ふつうこうにゅう	普通購入
ふつうきょういく	普通教育
ふつうがっきゅう	普通学級
ふっこしゅぎしゃ	復古主義者
ふっきんうんどう	腹筋運動
ふっきじょうほう	復帰情報
ふっかつちょくご	復活直後
ふっかつせんげん	復活宣言
ふっかつしゅほう	復活手法
ふちゅうほんまち	府中本町
ふちゅうひんとく	府中牝特
ふちゅうかいどう	府中街道
ふたりじょうしゃ	二人乗車
ふたまただいこん	二股大根
ふたまたごうやく	二股膏薬
ふたばていしめい	二葉亭四迷
ふたつひきりょう	二つ引両
ふたいほとっけん	不逮捕特権
ふたいじょうけん	付帯条件
ふぞくびょういん	附属病院
ふぞくこうじょう	付属工場
ふせつてんじかい	付設展示会
ふせいとうひょう	不正投票
ふせいじょうしゃ	不正乗車
ふせいかんきょう	不整環境
ふずいいこきゅう	不随意呼吸
ふじわらのていか	藤原定家
ふじょうりにっき	不条理日記
ふじょうほうほう	浮上方法
ふじゅうぶんせい	不十分性
ふじみしゅっぱん	富士見出版	富士美出版
ふじみこうじょう	富士見工場
ふじばなさんそう	藤花山荘
ふじつうぜねらる	富士通ゼネラル
ふじつうごたんだ	富士通五反田
ふじつうけいれつ	富士通系列
ふじつうおおいた	富士通大分
ふじさんごごうめ	富士山五合目
ふじくらでんせん	藤倉電線
ふしんにんひょう	不信任票
ふしんにんいけん	不信任意見
ふしょうわたくし	不肖私
ふしょうぶしょう	不承不承
ふしょうはんてい	負傷判定
ふしじひょうめい	不支持表明
ふざいしょうめい	不在証明
ふごうかほうほう	符号化方法
ふごうかほうしき	符号化方式
ふこくきょうへい	富國強兵	富国強兵
ふけんきょうかい	府県協会
ふくろだおんせん	袋田温泉
ふくりょうちょう	副寮長
ふくりこうせいひ	福利厚生費
ふくやまつううん	福山通運
ふくめんぱとかー	覆面パトカー
ふくながたけひこ	福永武彦
ふくちやましない	福知山市内
ふくたけしょてん	福武書店
ふくそりょういき	複素領域
ふくそたようたい	複素多様体
ふくそせいげんは	複素正弦波
ふくそきょうやく	複素共役
ふくせんかんかく	複線間隔
ふくせんかこうじ	複線化工事
ふくせいけんしゃ	複製権者
ふくすうへんすう	複数変数
ふくすうひょうき	複数表記
ふくすうだんらく	複数段落
ふくすうそんざい	複数存在
ふくすうせんたく	複数選択
ふくすうしんにん	複数信任
ふくすうしゅるい	複数種類
ふくすうしゃせん	複数車線
ふくすうしていか	複数指定可
ふくすうけいとう	複数系統
ふくすうがいしゃ	複数会社
ふくじてきこうか	副次的効果
ふくしりょういき	福祉領域
ふくしゅじんこう	副主人公
ふくしゅうにゅう	副収入
ふくしまてつどう	福島鉄道
ふくしまこうつう	福島交通
ふくしまこうこう	福島高校
ふくししゃちょう	副支社長
ふくしきこきゅう	腹式呼吸	複式呼吸
ふくざつどりろん	複雑度理論
ふくざつたりょう	複雑多量
ふくざつこっせつ	複雑骨折
ふくごうふきょう	複合不況
ふくごうびょうし	複合拍子
ふくごうたんぱく	複合蛋白
ふくごうそうこう	複合装甲
ふくごうこうげき	複合攻撃
ふくごうげんじつ	複合現実
ふくごうきぎょう	複合企業
ふくごうえきめい	複合駅名
ふくげんほうほう	復元方法
ふくげんさぎょう	復元作業
ふくげんえんそう	復原演奏
ふくおかほうそう	福岡放送
ふくおかてんじん	福岡天神
ふくおかだいがく	福岡大学
ふくおかこうだい	福岡工大
ふくおかけんない	福岡県内
ふくおかくうこう	福岡空港
ふくおかぎんこう	福岡銀行
ふくおかぎじゅつ	福岡技術
ふくおかきんこう	福岡近郊
ふくいけんちょう	福井県庁
ふくいけんしぞく	福井県士族
ふくいいんちょう	副委員長
ふきんじゅうみん	付近住民
ふきょうたいさく	不況対策
ふきょうこうえん	布教公演
ふきょうかつどう	布教活動
ふきゅうだいすう	普及台数
ふきゅうかつどう	普及活動
ふきそくへんどう	不規則変動
ふきあげぎょえん	吹上御苑
ふかんぜんほかん	不完全補完
ふかんぜんぎょう	不完全行
ふかせいぎょてん	付加制御点
ふかくていようそ	不確定要素
ふかくていじこう	不確定事項
ふかくていきげん	不確定期限
ふかぎゃくへんか	不可逆変化
ふぉるてっししも	fortessissimo
ふえきりゅうこう	不易流行
ふえきしょうあく	不易掌握
ふぇのーるじゅし	フェノール樹脂
ふうりゅういんじ	風流韻事
ふうましゅりけん	風魔手裏剣
ふうふりょうほう	夫婦両方
ふうせんばくだん	風船爆弾
ふうせいかくれい	風声鶴唳
ふうさんろしゅく	風餐露宿
ふうけいしゃしん	風景写真
ふぃーるずしょう	フィールズ賞
ふあんひょうめい	不安表明
ふあんざいりょう	不安材料
ふぁいるてんそう	ファイル転送
ひんどじょうほう	頻度情報
ひんしゅとうろく	品種登録
ひんしつほしょう	品質保証
ひんしつふりょう	品質不良
ひんしつひょうか	品質評価
ひんしつかくにん	品質確認
ひんしじょうほう	品詞情報
ひんしじょうたい	瀕死状態
ひんこんしゃかい	貧困社会
ひんこうほうせい	品行方正
ひろひとてんのう	裕仁天皇
ひろなかへいすけ	広中平祐
ひろすえりょうこ	広末涼子
ひろしまとうよう	広島東洋
ひろしまでんてつ	広島電鉄
ひろしまだいがく	広島大学
ひろしまたいかい	広島大会
ひろしまこうだい	広島工大
ひろしまけんない	広島県内
ひろしまけんせつ	広島建設
ひろしまくうこう	広島空港
ひろしまぎんこう	廣島銀行	広島銀行
ひろしまきんぼう	広島近傍
ひろさきだいがく	弘前大学
ひろかわしょてん	廣川書店
ひろおかかんとく	広岡監督
ひろうこうぎょう	披露興行
ひれいだいひょう	比例代表
ひりつじょうけん	比率条件
ひらぬまばしかん	平沼橋間
ひらかたこうえん	枚方公園
ひようたいこうか	費用対効果
ひょうろんかめい	評論家名
ひょうりゅうぶつ	漂流物
ひょうりゅうしゃ	漂流者
ひょうりいったい	表裏一体
ひょうもくひょう	標目表
ひょうめんじょう	表面上
ひょうめんしょり	表面処理
ひょうめんしょく	表面色
ひょうめんかこう	表面加工
ひょうめんおんど	表面温度
ひょうていそくど	表定速度
ひょうだいきょく	表題曲
ひょうたんなまず	瓢箪鯰
ひょうそうなだれ	表層雪崩
ひょうじょうゆた	表情豊
ひょうじゅんふく	標準服
ひょうじゅんひん	標準品
ひょうじゅんのう	標準脳
ひょうじゅんてき	標準的
ひょうじゅんじん	標準人
ひょうじゅんけい	標準型	標準形
ひょうじゅんきか	標準軌化
ひょうじゅんいち	標準位置
ひょうじゅんあん	標準案
ひょうじもじすう	表示文字数
ひょうじめんせき	表示面積
ひょうじほうほう	表示方法
ひょうじばいりつ	表示倍率
ひょうじないよう	表示内容
ひょうじてきいみ	表示的意味
ひょうじたいけい	表示体系
ひょうじせってい	表示設定
ひょうじせいのう	表示性能
ひょうじしきすう	表示色数
ひょうじけたすう	表示桁数
ひょうじけいたい	表示形態
ひょうじけいしき	表示形式
ひょうじきじゅん	表示基準
ひょうじかんけい	表示関係
ひょうしょうだい	表彰台
ひょうしょうしき	表彰式
ひょうしきどおり	標識通り
ひょうしきしょく	標識色
ひょうごけんりつ	兵庫県立
ひょうげんりょく	表現力
ひょうげんちょう	表現長
ひょうげんじょう	表現上
ひょうげんじたい	表現自体
ひょうげんしゅぎ	表現主義
ひょうげんぎほう	表現技法
ひょうげんきのう	表現機能
ひょうげんかのう	表現可能
ひょうげんいぜん	表現以前
ひょうけんだいり	表見代理
ひょうきほうほう	表記方法
ひょうきたいけい	表記体系
ひょうかほうほう	評価方法
ひょうかほうしき	評価方式
ひょうかてんすう	評価点数
ひょうかじゅんい	評価順位
ひょうかじっけん	評価実験
ひょうかしゃくど	評価尺度
ひょうかぎじゅつ	評価技術
ひょうかきじゅん	評価基準
ひょうかかんすう	評価関数
ひょうかかいせき	評価解析
ひょういもじてき	表意文字的
ひゃっきやぎょう	百鬼夜行
ひゃっかてんしき	百貨店式
ひゃっかてんがた	百貨店型
ひゃっかそうめい	百家争鳴
ひゃっかぜんしょ	百科全書
ひゃっかせいほう	百花斉放
ひゃくものがたり	百物語
ひゃくまんりょう	百万両	百萬両
ひゃくにんちょう	百人町
ひゃくせんれんま	百戦練磨	百戦錬磨
ひゃくすうじゅう	百数十
ひゃくじゅうおう	百獣王
ひゃくしょうよみ	百姓読み
ひゃくしゅうねん	百周年
ひゃくしきしてい	百式司偵
ひゃくごぎんこう	百五銀行
ひみんしゅこっか	非民主国家
ひみつとうひょう	秘密投票
ひみつしゅうかい	秘密集会
ひまんたんどらか	ヒマンタンドラ科	Himantandraceae
ひびやとしょかん	日比谷図書館
ひひょうげんてき	非表現的
ひばくしゃさべつ	被爆者差別	被曝者差別
ひはんてきいけん	批判的意見
ひはんたいしょう	批判対象
ひはんせいりょく	批判勢力
ひにちじょうてき	非日常的
ひにちじょうせい	非日常性
ひなんかのうせい	非難可能性
ひどらすちすあか	Hydrastidoideae	ヒドラスチス亜科
ひどうきつうしん	非同期通信
ひどうきたんまつ	非同期端末
ひとみすいしょう	瞳水晶
ひとみきねんかん	人見記念館
ひとばんいじょう	一晩以上
ひとなみいじょう	人並以上
ひとつひきりょう	一つ引両
ひとつきいじょう	一月以上
ひとじちかいほう	人質解放
ひとことふたこと	一言二言
ひとことちゅうい	一言注意
ひとくいじんしゅ	人喰い人種
ひとうひょうしゃ	被投票者
ひていてきたちば	否定的立場
ひていじょうてき	非定常的
ひていじょうせい	非定常性
ひていじょうおん	非定常音
ひていざいりょう	否定材料
ひつようまいすう	必要枚数
ひつようふかけつ	必要不可欠
ひつようしょるい	必要書類
ひつようさいてい	必要最低
ひつようこうせい	必要構成
ひつよういじょう	必要以上
ひつようあくてき	必要悪的
ひつもんひっとう	筆問筆答
ひっとしょうひん	ヒット商品
ひっすじょうしき	必須常識
ひっすじょうけん	必須条件
ひっしょうこうざ	必勝講座
ひっしゅうたんい	必修単位
ひっしゅうかもく	必修科目
ひちょっこうけい	非直交系
ひちょくせんせい	非直線性
ひちょうようしゃ	被徴用者
ひちゃくしゅつし	非嫡出子
ひだりどうろわき	左道路脇
ひだりてなかゆび	左手中指
ひだりじんごろう	左甚五郎
ひだひこやません	日田彦山線
ひたんちょうせい	非単調性
ひたちぶつりゅう	日立物流
ひたちちゅうけん	日立中研
ひたちじょうほう	日立情報
ひたちくれじっと	日立クレジット
ひたいしょうまく	非対称膜
ひたいしょうせい	非対象性	非対称性
ひたいしょううお	非対象魚
ひそうちゃくしゃ	非装着車
ひせんけいりろん	非線形理論
ひせんけいほかん	非線型補間
ひせんけいしょり	非線形処理
ひせんけいかほう	非線形加法
ひせんけいかがく	非線形科学
ひせんけいかいろ	非線形回路
ひせつどうこうか	非摂動効果
ひせっしょくしき	非接触式
ひせいしょくてき	非生殖的
ひじょうほうけい	非情報系
ひじょうていしゃ	非常停車
ひじょうせいどう	非常制動
ひじょうじいがい	非常時以外
ひじょうしゅだん	非常手段
ひじょうしきにん	非常識人
ひじょうかいだん	非常階段
ひじかたとしぞう	土方歳三
ひしんしゅうてき	非侵襲的
ひしょくぶんせき	比色分析
ひしょうがいしゃ	非障害者
ひしょうかいしゃ	被紹介者
ひしゃたいしんど	被写体深度
ひしゃかいしんど	被写界深度
ひしずめのまつり	鎮火の祭
ひさみつせいやく	久光製薬
ひさおじゅうらん	久生十蘭
ひさいはいふしゃ	被再配布者
ひこうじょうたい	飛行状態
ひこうじょうあと	飛行場跡
ひこうじかんてき	飛行時間的
ひこうしょうねん	非行少年
ひこうきりょこう	飛行機旅行
ひこうきえいこう	飛行機曳航
ひげいじゅつてき	非芸術的
ひきょじゅうしゃ	非居住者
ひきょくしょてき	非局所的
ひきょうごうてき	非競合的
ひきゅうほうこう	飛球方向
ひきすうしていじ	引数指定時
ひきすうかんすう	引数関数
ひきすういじょう	引数異常
ひがしむこうじま	東向島
ひがしまつやまし	東松山市
ひがしひろしまし	東広島市
ひがしはんきゅう	東半球
ひがしのしろえき	東能代駅
ひがしにほんへん	東日本編
ひがしにほんじん	東日本人
ひがしにほんけん	東日本圏
ひがしにほんけい	東日本系
ひがしとつかえき	東戸塚駅
ひがしところざわ	東所沢
ひがしとうきょう	東東京
ひがしせんだまち	東千田町
ひがしこうえんじ	東高円寺
ひがしかるいざわ	東軽井沢
ひがしおおさかし	東大阪市
ひがしおおぎじま	東扇島
ひがしおうめかん	東青梅間
ひがしうめだえき	東梅田駅
ひがしいちじょう	東一条
ひがしいけぶくろ	東池袋
ひがいじゅうみん	被害住民
ひがいしゃいしき	被害者意識
ひがいきゅうさい	被害救済
ひかんてきよそう	悲観的予想
ひかりふぁいばー	光ファイバー
ひかりじょうほう	光情報
ひかりじゅようき	光受容器
ひかりしょくばい	光触媒
ひかねつせいざい	非加熱製剤
ひかぜいしょとく	非課税所得
ひかくたいしょう	比較対象
ひかくげんごがく	比較言語学
ひかくえんざんし	比較演算子
ひえいりもくてき	非営利目的
ひえいりほうじん	非営利法人
ひえいりだんたい	非営利団体
ひえいきょうしゃ	非影響者
ひあっしゅくせい	非圧縮性
はんわこうぎょう	阪和興業
はんろんとうこう	反論投稿
はんれいいちらん	判例一覧
はんりっぽうたい	半立方体
はんようせいぎょ	汎用制御
はんようおおがた	汎用大形
はんめんきょうし	反面教師
はんぺんてんそる	反変テンソル
はんべつふかのう	判別不可能
はんべつしんごう	判別信号
はんべつしきほう	判別式法
はんべつきょうぎ	班別協議
はんぷくはいれつ	反復配列
はんぷくおんけい	反復音型
はんぶんほんとう	半分本当
はんぶんさんせい	半分賛成
はんぶんいじょう	半分以上
はんぱせいりゅう	半波整流
はんばいまいすう	販売枚数
はんばいほうほう	販売方法
はんばいほうしき	販売方式
はんばいてんとう	販売店頭
はんばいちゅうし	販売中止
はんばいだいすう	販売台数
はんばいたいせい	販売体制
はんばいそくしん	販売促進
はんばいせいせき	販売成績
はんばいじっせき	販売実績
はんばいけいやく	販売契約
はんばいけいたい	販売形態
はんばいきょてん	販売拠点
はんばいがいしゃ	販売会社
はんばいうちきり	販売打切り
はんのうはんぎょ	半農半漁
はんのうせっけい	反応設計
はんのうかくりつ	反応確率
はんにゅうとどけ	搬入届
はんにちかんこう	半日観光
はんにちいじょう	半日以上
はんどうたいそし	半導体素子
はんどうたいきき	半導体機器
はんとしほどまえ	半年程前
はんとしいじょう	半年以上
はんてんひょうじ	反転表示
はんてんこうしき	反転公式
はんていもんだい	判定問題
はんていほうほう	判定方法
はんていふかのう	判定不可能
はんていきじゅん	判定基準	判定規準
はんちょうようし	反跳陽子
はんちょうぼいん	半長母音
はんだんほりゅう	判断保留
はんだんきじゅん	判断基準	判断規準
はんだいつうしん	阪大通信
はんだいきそこう	阪大基礎工
はんたいほうめん	反対方面
はんたいほうこう	反対方向
はんたいにんずう	反対人数
はんたいとうこう	反対投稿
はんたいせいてき	反体制的
はんたいじんもん	反対尋問
はんたいしゃせん	反対車線
はんたいきゅうふ	反対給付
はんたいうんどう	反対運動
はんぞうもんせん	半蔵門線
はんぜいてんのう	反正天皇
はんせんうんどう	反戦運動
はんせいよくせつ	汎性欲説
はんせいふそしき	反政府組織
はんせいしゃざい	反省謝罪
はんすういじょう	半数以上
はんじゅくたまご	半熟卵
はんじゅうりょく	反重力
はんしんほんせん	阪神本線
はんしんでんてつ	阪神電鉄
はんしんでんしゃ	阪神電車
はんしんこくどう	阪神国道
はんしんこうそく	阪神高速
はんしんこうくう	阪神航空
はんしょくりょく	繁殖力
はんしょくひんば	繁殖牝馬
はんしょうかのう	反証可能
はんしゅりゅうは	反主流派
はんしゅうちょう	半周長
はんしゃぼうえん	反射望遠
はんしゃほうそく	反射法則
はんしゃとくせい	反射特性
はんしゃせいぶん	反射成分
はんしゃしんけい	反射神経
はんしゃこうぞう	反射構造
はんしゃこうしき	反射光式
はんしゃけいすう	反射係数
はんしゃきょうど	反射強度
はんしゃかんすう	反射関数
はんしゃかいてき	反社会的
はんしゃかいせい	反社会性
はんしゃおんあつ	反射音圧
はんしはんしょう	半死半生
はんざいはくしょ	犯罪白書
はんざいたいこく	犯罪大国
はんごひょうげん	反語表現
はんごうすいさん	飯盒炊爨
はんこつせいしん	反骨精神
はんこうせいめい	犯行声明
はんげんしりょく	反原子力
はんげきほうほう	反撃方法
はんけんしんせい	版権申請
はんけんしょゆう	版権所有
はんきゅうじょう	半球状	半球上
はんきゅうこしょ	阪急古書
はんきゅううめだ	阪急梅田
はんきゅういたみ	阪急伊丹
はんがげいじゅつ	版画芸術
はんがくめんじょ	半額免除
はんがきょうしつ	版画教室
はんかんはんみん	半官半民
はんかんせいひん	半完成品
はんかのうりょく	汎化能力
はんかくもじすう	半角文字数
はんかくへんかん	半角変換
はんかくぜんかく	半角全角
はんかくせいめい	反核声明
はんかくきりかえ	半角切替
はんかくかたかな	半角片仮名
はんかくえいすう	半角英数
はんかいしんけい	反回神経
はるやまこうえん	春山公園
はるみちのつらき	春道列樹
はるなつあきふゆ	春夏秋冬
はりだしせきわけ	張出関脇
はりだしこむすび	張出小結
はらんばんじょう	波瀾万丈	波乱万丈
はらいもどしきん	払戻金
はらいこみようし	払込用紙
はやひとのつかさ	隼人司
はやかわしょぼう	早川書房
はままつほうめん	浜松方面
はままつていしゃ	浜松停車
はままつたいかい	浜松大会
はままつぎじゅつ	浜松技術
はまなこめいさん	浜名湖名産
はまなこおおはし	浜名湖大橋
はぼまいしょとう	歯舞諸島
はなよめいしょう	花嫁衣装	花嫁衣裳
はなたばぞうてい	花束贈呈
はなぞのてんのう	花園天皇
はなぞのじんじゃ	花園神社
はながたじょゆう	花形女優
はながたしきしゃ	花形指揮者
はなおかこうざん	花岡鉱山
はどうおんきょう	波動音響
はとやまいちろう	鳩山一郎
はつわじょうほう	発話情報
はつらんはんせい	撥乱反正
はつぼうえいせん	初防衛戦
はつばいよていび	発売予定日
はつばいまどぐち	発売窓口
はつばいまいすう	発売枚数
はつばいほうほう	発売方法
はつばいびみてい	発売日未定
はつばいとうじつ	発売当日
はつばいとうしょ	発売当初
はつばいちょくご	発売直後
はつばいちゅうし	発売中止
はつばいぜんじつ	発売前日
はつばいしょにち	発売初日
はつばいけってい	発売決定
はつばいかいしび	発売開始日
はつばいかいしご	発売開始後
はつでんこうりつ	発電効率
はつしゅつじょう	初出場
はつしゅっそうば	初出走馬
はつこいでんせつ	初恋伝説
はつげんほうほう	発言方法
はつげんないよう	発言内容
はつげんけいしつ	発現形質
はつがんぶっしつ	発癌物質
はつおんひょうき	発音表記
はつおんきごうか	発音記号化
はつおんいじょう	発音異常
はっぽうふさがり	八方塞がり
はっぽうこうげん	白峰高原
はっぴょうようし	発表要旨	発表用紙
はっぴょうとうじ	発表当時
はっぴょうじゅん	発表順
はっぴょうじかん	発表時間
はっぴょうかいし	発表開始
はっぴょういらい	発表以来
はっとりせいこー	服部セイコー
はってんほうこう	発展方向
はってんとちゅう	発展途中
はってんとじょう	発展途上
はってんだんかい	発展段階
はっちゅうじゅん	発注順
はっちゃくじょう	発着場
はっちゃくじかん	発着時間
はったつだんかい	発達段階
はっそうほうほう	発想方法
はっそうふかのう	発送不可能
はっそうじょがい	発走除外
はっそうしゅだん	発送手段
はっそうぎょうむ	発送業務
はっせいよういん	発生要因
はっせいほうこう	発生方向
はっせいないよう	発声内容
はっせいげんいん	発生原因
はっせいかんかく	発生間隔
はっせいかくりつ	発生確立
はっせいかいすう	発生回数
はっしんほうほう	発振方法	発進方法
はっしんほうしき	発振方式
はっしんひょうき	八進表記
はっしんちょくご	発進直後
はっしんせんよう	発信専用
はっしゃほうこう	発射方向
はっしゃばんせん	発車番線
はっこうよていび	発行予定日
はっこうまいすう	発行枚数
はっこうほうほう	発行方法
はっこうばんごう	発行番号
はっこうせいぶつ	発光生物
はっこうじぎょう	発行事業
はっこうしゃべつ	発行社別
はっこうしじょう	発行市場
はっこうがいしゃ	発行会社
はっけんほうほう	発見方法	発券方法
はっくつばんぐみ	発掘番組
はっきんそうどう	発禁騒動
はっきんしょぶん	発禁処分
はっかくとうしょ	発覚当初
はちょうせいぶん	波長成分
はちめんれいろう	八面玲瓏
はちまんじんじゃ	八幡神社
はちはちかんたい	八八艦隊
はちのへくじせん	八戸久慈線
はちねんいじょう	八年以上
はちじゅうはちや	八十八夜
はだかでんきゅう	裸電球
はたのだいだんち	秦野台団地
はせがわとうはく	長谷川等伯
はじょうこうげき	波状攻撃
はじゃけんしょう	破邪顕正
はしょうふうきん	破傷風菌
はこだてほんせん	函館本線
はこがたしゃたい	箱型車体
はくわしょうせつ	白話小説
はくりきこむぎこ	薄力小麦粉
はくらんきょうき	博覧強記
はくぶんやくれい	博文約礼
はくはつはくぜん	白髪白髯
はくちょうのうた	白鳥の歌
はくちゅうむてき	白昼夢的
はくじんせんよう	白人専用
はくじんおんがく	白人音楽
はくしゅかっさい	拍手喝采
はくしゃくふじん	伯爵夫人
はくしじゃっこう	薄志弱行
はぎもときんいち	萩本欽一
はきょくすんぜん	破局寸前
はがんいっしょう	破顔一笑
はかたみなみえき	博多南駅
はかたにんぎょう	博多人形
はかせへんにゅう	博士編入
はかいもくひょう	破壊目標
はかいかのうぶつ	破壊可能物
はいれつへんすう	配列変数
はいれつひょうじ	配列表示
はいれつぜんたい	配列全体
はいれつせいやく	配列制約
はいれつけいさん	配列計算
はいぼくせんげん	敗北宣言
はいぶんほうほう	配分方法
はいぶつきしゃく	排仏棄釈	廃仏毀釈
はいふじょうけん	配布条件	配付条件
はいばんろうぜき	杯盤狼藉
はいばらぐんない	榛原郡内
はいとうせいこう	配当性向
はいていらおゆえ	海底撈月
はいたつほうほう	配達方法
はいたしゅぎてき	排他主義的
はいそうほうほう	配送方法
はいせんとうしゅ	敗戦投手
はいせんせつだん	配線切断
はいせんずしゅう	配線図集
はいせんいしょう	肺線維症
はいすいせいのう	排水性能
はいすいこうよう	排水口用
はいじんもくぜん	廃人目前
はいじんどうよう	廃人同様
はいじょかんこく	排除勧告
はいじょうみゃく	肺静脈
はいしゅつりょう	排出量
はいしゃふっかつ	敗者復活
はいしゃいんたい	敗者引退
はいしゃあつかい	廃車扱い
はいしちょくぜん	廃止直前
はいこうとくせい	配光特性
はいけいほうしゃ	背景放射
はいけいふくしゃ	背景輻射
はいけいちょうさ	背景調査
はいけいせってい	背景設定
はいけいざつおん	背景雑音
はいきゅうりょく	配給力
はいきゅうちゅう	肺吸虫
はいきみゃくどう	排気脈動
はいがんけんしん	肺癌検診
はいがいうんどう	排外運動
ほんほうそうとうじ	本放送当時
ほんほうそうじだい	本放送時代
ほんほうえいちゅう	本放映中
ほんぶんさんしょう	本文参照
ほんどぼうえいたい	本土防衛帯
ほんだひこうじょう	本田飛行場
ほんだそういちろう	本田宗一郎
ほんたいひだりした	本体左下
ほんせんみなみがわ	本線南側
ほんせんとっきゅう	本線特急
ほんじょあずまばし	本所吾妻橋
ほんしようきょだく	本使用許諾
ほんしゃしょざいち	本社所在地
ほんしゃこうじょう	本社工場
ほんしつてきぶぶん	本質的部分
ほんしつてきけんり	本質的権利
ほんこんなりたかん	香港成田間
ほんこんちゅうどく	香港中毒
ほんけんきゅうじょ	本研究所
ほんけんきゅうしつ	本研究室
ほんけんきゅうかい	本研究会
ほんけかいらんもと	本家回覧元
ほんかくはとうしゅ	本格派投手
ほりゅうじょうたい	保留状態
ほりばせいさくしょ	堀場製作所
ほねかわすじえもん	骨皮筋右衛門
ほっぽうけいげんご	北方系言語
ほっきにんいちどう	発起人一同
ほっかいどうろせん	北海道路線
ほっかいどうみなみ	北海道南
ほっかいどうほんぶ	北海道本部
ほっかいどうにっき	北海道日記
ほっかいどうどくじ	北海道独自
ほっかいどうとうぶ	北海道東部
ほっかいどうちほう	北海道地方
ほっかいどうしよう	北海道仕様
ほっかいどうしほん	北海道資本
ほっかいどうししゃ	北海道支社
ほぞんせいきょうか	保存性強化
ほそみんちょうたい	細明朝体
ほせいじょうきょう	補正状況
ほじょきおくそうち	補助記憶装置
ほじょかんじじしょ	補助漢字辞書
ほじゅうげんしょう	補充現象
ほしょうじょうけん	補償条件
ほしょうげんどがく	保障限度額
ほしょうきかんない	保証期間内
ほしゅうようぶひん	補修用部品
ほこうしゃゆうせん	歩行者優先
ほこうしゃてんごく	歩行者天国
ほこうしゃせんよう	歩行者専用
ほこうきつえんしゃ	歩行喫煙者
ほけんがいこういん	保険外交員
ほけんかんゆういん	保険勧誘員
ほくりくでんりょく	北陸電力
ほくりくだいひょう	北陸代表
ほくぶきゅうしゅう	北部九州
ほくだいびょういん	北大病院
ほくだいせいきょう	北大生協
ほくだいこうがくぶ	北大工学部
ほくしんきゅうこう	北神急行
ほきょうようぶひん	補強用部品
ほきゅうじょうたい	補給状態
ほかんじょうきょう	保管状況
ほかくだんめんせき	捕獲断面積
ほうわすいようえき	飽和水溶液
ほうわじょうきあつ	飽和蒸気圧
ほうわじそくみつど	飽和磁束密度
ほうれいしんさけん	法令審査権
ほうりつそうだんぶ	法律相談部
ほうりつじょうほご	法律上保護
ほうらくまんじゅう	蜂楽饅頭
ほうほうろんじしん	方法論自身
ほうにんじょうたい	放任状態
ほうどうはっぴょう	報道発表
ほうどうしゃしんか	報道写真家
ほうどうきょうてい	報道協定
ほうていだいりにん	法定代理人
ほうていしきりろん	方程式理論
ほうそうぶんかなど	放送文化等
ほうそうじゅんじょ	放送順序
ほうそうじかんない	放送時間内
ほうそうじかんたい	放送時間帯
ほうそうしゅっぱん	放送出版
ほうそうさんぎょう	放送産業
ほうそうけんりょう	放送権料
ほうそうぎょうかい	放送業界
ほうそうきょくよう	放送局用
ほうそうきょくめい	放送局名
ほうそうきょうかい	放送協会
ほうそうえんちょう	放送延長
ほうせつかごうぶつ	包接化合物
ほうせいしんぎかい	法制審議会
ほうじょうまさむね	北条正宗
ほうじょうそううん	北条早雲
ほうしんじょうたい	放心状態
ほうしゅつりゅうし	放出粒子
ほうしゃのうひばく	放射能被曝
ほうしゃのうおせん	放射能汚染
ほうしゃそうしょう	放射相称
ほうしゃせんひばく	放射線被曝
ほうしゃせんしょり	放射線処理
ほうしゃせいげんそ	放射性元素
ほうしゃかどうかん	放射仮導管
ほうこうしゅうせい	方向修正
ほうけんてきせいど	封建的制度
ほうけいじかんまど	方形時間窓
ほうけいけいがくぶ	法経系学部
ほうかつしょうけい	包括承継
ほうかだいがくいん	法科大学院
ほうかいじょうたい	崩壊状態
ほうえいじゅんじょ	放映順序
ほうえいじかんやく	放映時間約
ほうえいけんりょう	放映権料
ほうえいえんちょう	放映延長
ほうあんていしゅつ	法案提出
へんろちょうちょう	変ロ長調
へんほちょうちょう	変ホ長調
へんへちょうちょう	変ヘ長調
へんびぶんけいすう	偏微分係数
へんびぶんけいしき	偏微分形式
へんはちょうちょう	変ハ長調
へんにちょうちょう	変ニ長調
へんどうそうばせい	変動相場制
へんとちょうちょう	変ト長調
へんちょうほうしき	変調方式
へんそうりょうきん	返送料金
へんせいぞうきょう	編成増強
へんすうめいほかん	変数名補完
へんすうじょうほう	変数情報
へんすうじょうけん	変数条件
へんすうかんきょう	変数環境
へんしんようきって	返信用切手
へんしんのうりょく	変身能力
へんしんさきめいき	返信先明記
へんしゅうめいれい	編集命令
へんしゅうほうしん	編集方針
へんしゅうないよう	編集内容
へんしゅうないがい	編集内外
へんしゅうとちゅう	編集途中
へんしゅうちょさく	編集著作
へんしゅうしゅにん	編集主任
へんしゅうしゅかん	編集主幹
へんしゅうさぎょう	編集作業
へんしつきょうてき	偏執狂的
へんこうようきゅう	変更要求
へんこうたいしょう	変更対象
へんこうじょうほう	変更情報
へんこうしようしょ	変更仕様書
へんきんたいしょう	返金対象
へんきょくたんとう	編曲担当
へんかんのうりょく	変換能力
へんかんたいしょう	変換対象
へんかんじょうたい	変換状態
へんかんさぎょうご	変換作業後
へんかんぎょうれつ	変換行列
へんかんきじゅつし	変換記述子
へんかんききこうざ	変換機器講座
へんかんかいしてん	変換開始点
へんかんかいしいち	変換開始位置
へんいちょうちょう	変イ長調
へんあつきそうおん	変圧器騒音
へいわてきかいけつ	平和的解決
へいわいじかつどう	平和維持活動
へいれつろんりがた	並列論理型
へいれつじゅうでん	並列充電
へいれつけいさんき	並列計算機
へいれつがくしゅう	並列学習
へいめんげいじゅつ	平面芸術
へいそくじょうたい	閉塞状態
へいそうしゃりょう	並走車両
へいぜいごうじょう	平生業成
へいじょううんてん	平常運転
へいこうみゃくよう	平行脈葉
へいこうじょうたい	平衡状態
へいこうしへんけい	平行四辺形
へいこうがたきこう	平行型気孔
へいこういぬしょり	平行犬処理
へいけつうんてんじ	併結運転時
へいきんれんさすう	平均連鎖数
へいきんまちじかん	平均待ち時間
へいきんねんしゅう	平均年収
へいきんねつそくど	平均熱速度
へいきんてきせたい	平均的世帯
へいきんじゅみょう	平均寿命
へいきんしんちょう	平均身長
へいきんきょくりつ	平均曲率
へいきんかいつうび	平均開通日
へいきょくせんない	閉曲線内
ふんしょくけっさん	粉飾決算
ふんしゃねんりょう	噴射燃料
ふるかわこうぎょう	古河鉱業
ふりょうしょうじょ	不良少女
ふりょうさいけんか	不良債権化
ふりこつうきんしゃ	振子通勤車
ふりかえきゅうじつ	振替休日
ふようしゃこうじょ	扶養者控除
ふようかぞくてあて	扶養家族手当
ふほうわしぼうさん	不飽和脂肪酸
ふほうたいざいしゃ	不法滞在者
ふへんてきりっぽう	普遍的立法
ふへんてきほうそく	普遍的法則
ふへんしゅうきょう	普遍宗教
ふどうにゅうりょく	浮動入力
ふどうさんじぎょう	不動産事業
ふどうさんこうこく	不動産広告
ふどうさんがいしゃ	不動産会社
ふともももくあぐん	フトモモ目亜群
ふていこうせいさく	不抵抗政策
ふつうしゃめんきょ	普通車免許
ふつううんちんよう	普通運賃用
ふっきゅうほうほう	復旧方法
ふっきゅうさぎょう	復旧作業
ふたんじゅうりょう	負担重量
ふたまたみゃくけい	二又脈系
ふたごやまおやかた	二子山親方
ふたごたまがわえん	二子玉川園
ふじんさんせいけん	婦人参政権
ふじわらのよしたか	藤原義孝
ふじわらのもととし	藤原基俊
ふじわらのみちなが	藤原道長
ふじわらのすみとも	藤原純友
ふじわらのおきかぜ	藤原興風
ふじよしだひまつり	富士吉田火祭
ふじつうあつぎけん	富士通厚木研
ふしょうたいじょう	負傷退場
ふしょうけつじょう	負傷欠場
ふしゃくしんみょう	不惜身命
ふこうせいとりひき	不公正取引
ふけいべつはんだん	父系別判断
ふくりょうりちょう	副料理長
ふくりこうせいてき	福利厚生的
ふくひょうじようそ	副表示要素
ふくだいとうりょう	副大統領
ふくそりきがくけい	複素力学系
ふくそすうえんざん	複素数演算
ふくそしゅうはすう	複素周波数
ふくそかんすうろん	複素関数論
ふくせんかかんせい	複線化完成
ふくせいとうかせい	複製透過性
ふくすうにんいいん	複数人委員
ふくすうとくひょう	複数得票
ふくすうとうひょう	複数投票
ふくすうちょくれつ	複数直列
ふくすうせんたくか	複数選択可
ふくすうごうぎせい	複数合議制
ふくすうかいとうか	複数解答可	複数回答可
ふくしょくこうぼう	服飾工房
ふくしゃさいはいふ	複写再配布
ふくしまけんなんぶ	福島県南部
ふくしまいやくだい	福島医薬大
ふくごうりょういき	複合領域
ふくごうひょうげん	複合表現
ふくごうどうじゅん	複号同順
ふくごうごゆうせん	複合語優先
ふくごうきょくせん	複合曲線
ふくくみあいちょう	副組合長
ふくおかしないせん	福岡市内線
ふくおかこうだいふ	福岡工大附
ふきそくがたきこう	不規則型気孔
ふかのうせいていり	不可能性定理
ふかくていとうこう	不確定投稿
ふかくていかんけい	不確定関係
ふかくだいほうしん	不拡大方針
ふかぎゃくはんのう	不可逆反応
ふかかちきょうそう	付加価値競争
ふかかいげんしょう	不可解現象
ふうりょくはつでん	風力発電
ふうふざいさんせい	夫婦財産制
ふうぜんのともしび	風前の灯
ふうえいほういはん	風営法違反
ふあんていよういん	不安定要因
ふーりえきゅうすう	フーリエ級数
ひんばげんていせん	牝馬限定戦
ひんしゅかいりょう	品種改良
ひんしぶんかいずみ	品詞分解済
ひんしつほじきげん	品質保持期限
ひんしつほしょうぶ	品質保証部
ひんしつこうじょう	品質向上
ひんしかんせつぞく	品詞間接続
ひろんりてきこうり	非論理的公理
ひろでんしないせん	広電市内線
ひろしまでんきだい	広島電機大
ひろしましりつだい	広島市立大
ひろしまくれどうろ	広島呉道路
ひれいけいすうかん	比例計数管
ひらまくゆうしょう	平幕優勝
ひらかたひがしぐち	枚方東口
ひょうろんかやろう	評論家野郎
ひょうろんかつどう	評論活動
ひょうめんせいぎょ	表面制御
ひょうめんじっそう	表面実装
ひょうめんおんどさ	表面温度差
ひょうめいほうほう	表明方法
ひょうほんてんすう	標本点数
ひょうていそくどひ	表定速度比
ひょうていしゃくど	評定尺度
ひょうちゅうきごう	表中記号
ひょうじりょういき	表示領域
ひょうじょうしゅう	評定衆
ひょうじょうがわら	評定河原
ひょうじゅんりろん	標準理論
ひょうじゅんもけい	標準模型
ひょうじゅんへんさ	標準偏差
ひょうじゅんぶひん	標準部品
ひょうじゅんふぞく	標準付属
ひょうじゅんでんぱ	標準電波
ひょうじゅんてんぷ	標準添付
ひょうじゅんそうび	標準装備
ひょうじゅんせいず	標準星図
ひょうじゅんじかん	標準時間
ひょうじゅんしよう	標準仕様
ひょうじゅんしょく	標準色
ひょうじゅんしてい	標準指定
ひょうじゅんしげき	標準刺激
ひょうじゅんきょく	標準局
ひょうじゅんきのう	標準機能
ひょうじゅんきどう	標準軌道
ひょうじゅんきかん	標準軌間
ひょうじゅんきかく	標準規格
ひょうじゅんかんじ	標準漢字
ひょうじゅんかせき	標準化石
ひょうじゅんかかく	標準価格
ひょうじゅんいがい	標準以外
ひょうじのうりょく	表示能力
ひょうじじょうほう	表示情報
ひょうじかのうせい	表示可能性
ひょうしょうじょう	表彰状
ひょうしょうしゅぎ	表象主義
ひょうしょうきのう	表象機能
ひょうしきばんごう	標識番号
ひょうしきつうかじ	標識通過時
ひょうごけんよせん	兵庫県予選
ひょうごけんほくぶ	兵庫県北部
ひょうごけんちょう	兵庫県庁
ひょうげんもじれつ	表現文字列
ひょうげんほうほう	表現方法
ひょうげんふかのう	表現不可能
ひょうげんないよう	表現内容
ひょうげんだんあつ	表現弾圧
ひょうげんぜんたい	表現全体
ひょうげんしゅほう	表現手法
ひょうげんしゅだん	表現手段
ひょうげんけいたい	表現形態
ひょうげんけいしき	表現形式
ひょうげんかつどう	表現活動
ひょうけいほうもん	表敬訪問
ひょうぎいいんかい	評議委員会
ひょうかのうりょく	評価能力
ひょうかたいしょう	評価対象
ひょうかじょうけん	評価条件
ひょうかじゅんじょ	評価順序
ひょうかかんきょう	評価環境
ひょうおんもじてき	表音文字的
ひょうおんもじせい	表音文字性
ひやくてきしんてん	飛躍的進展
ひゃっかりょうらん	百花繚乱
ひゃっかぜんしょは	百科全書派
ひゃっかぜんしょか	百科全書家
ひゃくやくのちょう	百薬の長
ひゃくまんえんいか	百万円以下
ひゃくはちぼんのう	百八煩悩
ひゃくはちじゅうど	百八十度
ひゃくねんせんそう	百年戦争
ひゃくにんいっしゅ	百人一首
ひゃくにんいじょう	百人以上
ひゃくにじゅうにち	百二十日
ひゃくてんまんてん	百点満点
ひゃくだいいじょう	百台以上
ひゃくしょういっき	百姓一揆
ひゃくしきゆそうき	百式輸送機
ひゃくえんらいたー	百円ライター
ひもとせきにんしゃ	火元責任者
ひみつほじけいやく	秘密保持契約
ひみつつみたてきん	秘密積立金
ひみつちょうさいん	秘密調査員
ひぼうちゅうしょう	誹謗中傷
ひぶそうちゅうりつ	非武装中立
ひふかがくしんだん	皮膚科学診断
ひはんてきしつもん	批判的質問
ひどろすたきすもく	Hydrostachydales	ヒドロスタキス目
ひとでじょうきょう	人出状況
ひとつばしだいがく	一橋大学
ひとじちせんじゅつ	人質戦術
ひとじちしゃくほう	人質釈放
ひとうほうさんらん	非等方散乱
ひていてきひょうか	否定的評価
ひていてきけつろん	否定的結論
ひづけへんこうせん	日付変更線
ひつようじょうけん	必要条件
ひつようじゅうぶん	必要十分	必要充分
ひっしょうたいせい	必勝体制
ひっさつしごとにん	必殺仕事人
ひっさつしかけにん	必殺仕掛人
ひちょっこうきてい	非直交基底
ひだんせいさんらん	非弾性散乱
ひだりがわつうこう	左側通行
ひだりがわぜんぽう	左側前方
ひだりがわしゃせん	左側車線
ひたんちょうろんり	非単調論理
ひたちぼうかいそん	常陸坊海尊
ひたちせいさくじょ	日立製作所
ひたちせいさくしょ	日立製作所
ひたいかくせいぶん	非対角成分
ひたいいくかいけい	非体育会系
ひそうたいろんてき	非相対論的
ひそうかんざつおん	非相関雑音
ひぜんやまぐちえき	肥前山口駅
ひせんけいりきがく	非線型力学
ひせんけいへんかん	非線形変換
ひせんけいにんしき	非線型認識
ひせんけいせいきか	非線形正規化
ひせんけいしゃぞう	非線型写像
ひせんけいこうたい	非線型後退
ひせんけいかんすう	非線型関数
ひせんぎょうしゅふ	非専業主婦
ひせっていしゃしゅ	非設定車種
ひせきぶんかんすう	被積分関数
ひせいしょくこうい	非生殖行為
ひじょうようそうび	非常用装備
ひじょうじょうこく	非常上告
ひじょうきんこうし	非常勤講師
ひじょうきんぎかん	非常勤技官
ひじみんせいりょく	非自民勢力
ひしんしてきこうい	非紳士的行為
ひしょうひししゅつ	非消費支出
ひしゅうたんきごう	非終端記号
ひしゅうぎょうしゃ	非就業者
ひさべつぶらくみん	被差別部落民
ひさいしょういそう	非最小位相
ひこてんてきこうし	非古典的光子
ひこくみんあつかい	非国民扱い
ひこうしきけんかい	非公式見解
ひげんごてきちしき	非言語的知識
ひぎんえんしゃしん	非銀塩写真
ひきょうりょくてき	非協力的
ひきとりじょうけん	引取条件
ひきつえんじんこう	非喫煙人口
ひきつえんうんどう	非喫煙運動
ひきすうひょうかじ	引数評価時
ひきごうてききしつ	非記号的基質
ひがしやまてんのう	東山天皇
ひがしやまごじょう	東山五条
ひがしひろしまかん	東広島間
ひがしひろしまえき	東広島駅
ひがしにほんいがい	東日本以外
ひがしなかやまかん	東中山間
ひがしせんだいかん	東仙台間
ひがしじゅうりょう	東十両
ひがしじゅうじょう	東十条
ひがししおじりえき	東塩尻駅
ひがしきりゅうえき	東桐生駅
ひがしきたざわえき	東北沢駅
ひがしがわじんえい	東側陣営
ひがしがわしょこく	東側諸国
ひがしがわしゃかい	東側社会
ひがしかわぐちえき	東川口駅
ひがしおおしまかん	東大島間
ひがしおおさかせん	東大阪線
ひがしいずほうめん	東伊豆方面
ひがいもうそうてき	被害妄想的
ひがいじょうきょう	被害状況
ひかんじぶんかけん	非漢字文化圏
ひかりちゅうせいし	光中性子
ひかりそうさそうち	光走査装置
ひかりしゅつりょく	光出力
ひかりきゅうしゅう	光吸収
ひかぜいぎょうしゃ	非課税業者
ひかいせきしんごう	被解析信号
ひかいせきかんすう	被解析関数
ひかいいんがくせい	非会員学生
ひおんせいがくてき	非音声学的
ひえいざんこうこう	比叡山高校
ひあっしゅくりゅう	非圧縮流
ひあっしゅくきろく	非圧縮記録
はんろんしょうめい	反論証明
はんれいけんきゅう	判例研究
はんようけいさんき	汎用計算機
はんようおおがたき	汎用大型機
はんべいかんじょう	反米感情
はんぷくがくしゅう	反復学習
はんぶんじょくれい	繁文縟礼
はんぶんじょうだん	半分冗談
はんばいりょういき	販売領域
はんばいだいりてん	販売代理店
はんばいせんりゃく	販売戦略
はんばいじょうほう	販売情報
はんばいじょうけん	販売条件
はんばいじぎょうぶ	販売事業部
はんのうそくどろん	反応速度論
はんのうそくどしき	反応速度式
はんにんまえみまん	半人前未満
はんにゃしんぎょう	般若心経
はんにゃしんきょう	般若心経
はんにちせいりょく	反日勢力
はんにちかんじょう	反日感情
はんていじょうけん	判定条件
はんちょっかんてき	反直観的
はんちょうりゅうし	反跳粒子
はんだんのうりょく	判断能力
はんだんざいりょう	判断材料
はんだいこうがくぶ	阪大工学部
はんたいひょうめい	反対表明
はんたいはのうみん	反対派農民
はんたいとうひょう	反対投票
はんたいしょうりつ	反対称律
はんたいしょうせい	反対称性
はんたいしゃたすう	反対者多数
はんそくとうきゅう	反則投球
はんそくきんせいど	反則金制度
はんせいふうんどう	反政府運動
はんしんしょうがい	阪神障害
はんしんきゅうこう	阪神急行
はんしょくほうほう	繁殖方法
はんしょくかつどう	繁殖活動
はんしゃざいりょう	反射材料
はんしゃおんじょう	反射音場
はんざいにゅうもん	犯罪入門
はんざいしゅうだん	犯罪集団
はんざいしゃしんり	犯罪者心理
はんさべつようごは	反差別用語派
はんこていていこう	半固定抵抗
はんげつそんしょう	半月損傷
はんけつぶんちゅう	判決文中
はんきゅうふぇりー	阪九フェリー
はんきゅうとうほう	阪急東宝
はんきゅうでんてつ	阪急電鉄
はんきゅうでんしゃ	阪急電車
はんきゅうつかぐち	阪急塚口
はんきゅうしんしゃ	阪急新車
はんきゅうさいいん	阪急西院
はんきゅうけいれつ	阪急系列
はんきゅうえんせん	阪急沿線
はんがめいさくてん	版画名作展
はんかんせつわほう	半間接話法
はんかくざいりょう	販拡材料
はんかくえいすうじ	半角英数字
はんえいきゅうてき	半永久的
はやごせんしゅけん	早碁選手権
はやかわぶんこばん	早川文庫版
はままつひゃくせん	浜松百選
はままつちょうえき	浜松町駅
はなよめにんぎょう	花嫁人形
はなよめしゅぎょう	花嫁修行
はなはくかいじょう	花博会場
はながたさんぎょう	花形産業
はどうほうていしき	波動方程式
はつばいびよくじつ	発売日翌日
はつばいびとうじつ	発売日当日
はつばいちょくぜん	発売直前
はつばいじょうほう	発売情報
はつばいじこくまえ	発売時刻前
はつとうこうきねん	初投稿記念
はつでんきかんけい	発電機関係
はつたんぺんしゅう	初短篇集
はつおんれんしゅう	発音練習
はつおんきごうれつ	発音記号列
はっぽうびじんてき	八方美人的
はっぽうすちろーる	発泡スチロール
はっぴょうろんぶん	発表論文
はっぴょうぼしゅう	発表募集
はっぴょうばんごう	発表番号
はっぴょうねんだい	発表年代
はっぴょうないよう	発表内容
はっぴょうとうしょ	発表当初
はっぴょうだいもく	発表題目
はっぴょうだいめい	発表題名
はっぴょうしりょう	発表資料
はっぴょうしゃめい	発表者名
はっぴょうこうえん	発表講演
はっぴょうけんすう	発表件数
はっぴょうけいたい	発表形態
はっぴょうけいしき	発表形式
はっぴょうがいよう	発表概要
はっぴゃくやちょう	八百八町
はっとりとけいてん	服部時計店
はってんとじょうき	発展途上期
はってんかのうせい	発展可能性
はったつしんりがく	発達心理学
はったつしょうがい	発達障害
はっせいれんしゅう	発声練習
はっせいねんがっぴ	発生年月日
はっしんにんばらい	発信人払い
はっしんじょうたい	発信状態
はっしょくとくせい	発色特性
はっしょうねんれい	発症年齢
はっしゅうけんがく	八宗兼学
はっしゃちょくぜん	発車直前
はっこうびとりひき	発行日取引
はっこうびぜんじつ	発行日前日
はっこうねんがっぴ	発行年月日
はっこうだいおーど	発光ダイオード
はっこうせんでんか	八高線電化
はっこうじょうたい	発酵状態
はっこうじゅみょう	発光寿命
はっけんしゃいがい	発見者以外
はっけんがくしゅう	発見学習
はっきょうすんぜん	発狂寸前
はちょういぞんせい	波長依存性
はちおうじほうめん	八王子方面
はちおうじじっせん	八王子実践
はちおうじこうこう	八王子高校
はせがわこうむてん	長谷川工務店
はしもととっきゅう	橋本特急
はさんほごしんせい	破産保護申請
はさんかんざいにん	破産管財人
はこものちゅうしん	箱物中心
はこにわりょうほう	箱庭療法
はくりょくまんてん	迫力満点
はくしょくわいせい	白色矮星
はくしょくじんしゅ	白色人種
はくしょくざつおん	白色雑音
はくしゃせいしょう	白砂青松
はくしいにんじょう	白紙委任状
はくいんぼうしょう	博引旁証
はぎわらさくたろう	萩原朔太郎
はかたえきこうつう	博多駅交通
はかせぜんきかてい	博士前期課程
はかせこうきかてい	博士後期課程
はかせかていぜんき	博士課程前期
はかせかていこうき	博士課程後期
はかいこうさくしゃ	破壊工作者
はいれつりょういき	配列領域
はいふはんいいがい	配布範囲以外
はいふてすうりょう	配布手数料
はいふうやなぎだる	誹風柳多留
はいひんかいしゅう	廃品回収
はいばんじょうほう	廃盤情報
はいにょうこんなん	排尿困難
はいちじょうきょう	配置状況
はいたてきろんりわ	排他的論理和
はいたつしょうめい	配達証明
はいせんざいりょう	配線材料
はいせんぎょうしゃ	配線業者
はいすいのうりょく	排水能力
はいじょのうりょく	排除能力
はいしゅつきじゅん	排出基準
はいしゃりょうすう	廃車両数
はいしゃちょくぜん	廃車直前
はいしゃしゃりょう	廃車車両
はいぐうしゃてあて	配偶者手当
はいきゅうがいしゃ	配給会社
はいえんのうりょく	排煙能力
はいいろいっしょく	灰色一色
ほんほうえいちょくご	本放映直後
ほんぶんしょうりゃく	本文省略
ほんばばにゅうじょう	本馬場入場
ほんちすいじゃくせつ	本地垂迹説
ほんたいじゅうりょう	本体重量
ほんせんしゅつじょう	本戦出場
ほんじすいじゃくせつ	本地垂迹説
ほんしゅうじょうりく	本州上陸
ほんしつてきもんだい	本質的問題
ほんしつてきかいけつ	本質的解決
ほんごうさんちょうめ	本郷三丁目
ほんがくだいがくいん	本学大学院
ほんかくてきさんせん	本格的参戦
ほっかいどうりょこう	北海道旅行
ほっかいどうつうしん	北海道通信
ほっかいどうだいがく	北海道大学
ほっかいどうしんぶん	北海道新聞
ほっかいどうさんまい	北海道産米
ほっかいどうげんてい	北海道限定
ほっかいどうえんがん	北海道沿岸
ほしゅけいやくりょう	保守契約料
ほくりくせんたんだい	北陸先端大
ほくりくしんかんせん	北陸新幹線
ほくだいきょうようぶ	北大教養部
ほかんほぞんほうほう	保管保存方法
ほうりんどうしょてん	芳林堂書店
ほうりつてきもんだい	法律的問題
ほうりつてきせいやく	法律的制約
ほうりつてきこんきょ	法律的根拠
ほうりつてきぎじゅつ	法律的技術
ほうりつじょうかのう	法律上可能
ほうりつじょういほう	法律上違法
ほうもんはんばいほう	訪問販売法
ほうむちょうけんかい	法務庁見解
ほうほうろんてきいみ	方法論的意味
ほうどうさつえいよう	報道撮影用
ほうどうかんけいしゃ	報道関係者
ほうていじゅんびきん	法定準備金
ほうだんかいほうこく	放談会報告
ほうそうよていじかん	放送予定時間
ほうそうじぎょうしゃ	放送事業者
ほうそうしゅうりょう	放送終了
ほうそうしゅうはすう	放送周波数
ほうそうきんしようご	放送禁止用語
ほうしゅういいんかい	報酬委員会
ほうしゃのうそくてい	放射能測定
ほうしゃせんちりょう	放射線治療
ほうしゃせんたいさく	放射線対策
ほうしゃせんそくてい	放射線測定
ほうしゃせんじっけん	放射線実験
ほうしゃせんしょうい	放射線照射
ほうしゃせいぶっしつ	放射性物質
ほうしゃせいかくしゅ	放射性核種
ほうこうべつはいせん	方向別配線
ほうかつめんきょせい	包括免許制
ほうかついにんじょう	包括委任状
ほうえいじょうきょう	放映状況
ほうえいじかんいがい	放映時間以外
ほういがくきょうしつ	法医学教室
ほいくしょにゅうしょ	保育所入所
ほいくしょしょくいん	保育所職員
へんちょうどとくせい	変調度特性
へんじゅんいそうかん	偏順位相関
へんしんようふうとう	返信用封筒
へんしゅうたいしょう	編集対象
へんしゅうしゃちゅう	編集者注
へんしゅうしゃかいぎ	編集者会議
へんしゅうきょうてき	偏執狂的
へんしゅうかんきょう	編集環境
へんしゅういいんかい	編集委員会
へんこうはんどうたい	偏向半導体
へんこうせいかんそく	変光星観測
へんこうしんせいしょ	変更申請書
へんこうかんりひょう	変更管理票
へんきょくでんしせん	偏極電子線
へいわきねんこうえん	平和記念公園
へいれつぶんさんがた	並列分散型
へいれつふかぶんさん	並列負荷分散
へいれつはんぷくほう	並列反復法
へいれつしょりげんご	並列処理言語
へいれつけいてきおう	並列形適応
へいりょくぞうきょう	兵力増強
へいぼんしゃはっこう	平凡社発行
へいとうしょうしゅつ	平頭抄出
へいさようみゃくけい	閉鎖葉脈系
へいこうゆにゅうぶつ	並行輸入物
へいこうゆにゅうひん	並行輸入品
へいこうざいらいせん	並行在来線
へいきんじじょうごさ	平均2乗誤差	平均二乗誤差
へいきんしゅつりょく	平均出力
へいきんしゅうにゅう	平均収入
へいきんあやまりりつ	平均誤り率
へいきょくせんていり	閉曲線定理
ふんりゅうすいしんき	噴流推進機
ふんたいこうがっかい	粉体工学会
ふれんぞくちょうやく	不連続跳躍
ふるかわえきにしぐち	古河駅西口
ふりょうとうこうしゃ	不良投稿者
ふりょうしゃかいじん	不良社会人
ふりょうこうこうせい	不良高校生
ふりこみてすうりょう	振込手数料
ふりかえてすうりょう	振替手数料
ふみきりじこたいさく	踏切事故対策
ふほうこういせきにん	不法行為責任
ふへんひふくしゃぞう	普遍被覆写像
ふなばしけいばじょう	船橋競馬場
ふどうしょうすうてん	浮動小数点
ふどうしょうすうがた	浮動小数型
ふどうさんとうきほう	不動産登記法
ふどうさんちゅうかい	不動産仲介
ふどうさんぎょうしゃ	不動産業者
ふどうさんかんていし	不動産鑑定士
ふとうろうどうこうい	不当労働行為
ふとうめいけっちゃく	不透明決着
ふつうじょうようしゃ	普通乗用車
ふつうじょうしゃけん	普通乗車券
ふつうしゅうゆうけん	普通周遊券
ふつうしゃじゆうせき	普通車自由席
ふつうしゃしていせき	普通車指定席
ふってんじょうしょう	沸点上昇
ふちゅうしけんじょう	府中試験場
ふぞくめいさいひょう	付属明細表
ふぞくけんきゅうじょ	付属研究所
ふじゅうりょくじょう	負重力場
ふじつうほっかいどう	富士通北海道
ふじつうこくさいけん	富士通国際研
ふじさんちょうじょう	富士山頂上
ふじさわしみんまつり	藤沢市民祭
ふしんにんひょうめい	不信任表明
ふしょくふひょうめん	不織布表面
ふしつりょうぶっしつ	負質量物質
ふざいしゃとうひょう	不在者投票
ふごうかくちょうほう	符合拡張法	符号拡張法
ふくりこうせいしせつ	福利厚生施設
ふくそへいめんじょう	複素平面上
ふくそいそうくうかん	複素位相空間
ふくせいげんがしゅう	複製原画集
ふくせいけんしんがい	複製権侵害
ふくすうにゅうりょく	複数入力
ふくしょうひょうすう	複勝票数
ふくしゃきじぎょうぶ	複写機事業部
ふくしまみんぽうはい	福島民放杯	福島民報杯
ふくごうせいさんぶつ	複合生産物
ふくこうかんしんけい	副交感神経
ふくおかとしこうそく	福岡都市高速
ふくおかこうたんだい	福岡工短大
ふくいんかんしょてん	福音館書店
ふかんぜんねんしょう	不完全燃焼
ふかんぜんせきぶんき	不完全積分器
ふかんぜんせいていり	不完全性定理
ふかんぜんじょうほう	不完全情報
ふかんぜんきょうそう	不完全競争
ふかぶんさんほうしき	負荷分散方式
ふかくていせいげんり	不確定性原理
ふかぎゃくあっしゅく	不可逆圧縮
ふうろそうもくあぐん	フウロソウ目亜群
ふうえいほうかいせい	風営法改正
ふあんていとくいてん	不安定特異点
ふあんしんけいしょう	不安神経症
ひろしまちゅうしんぶ	広島中心部
ひろしまじょがくいん	広島女学院
ひろしましんこうつう	広島新交通
ひろしましょうぎょう	広島商業
ひろしまくまのどうろ	広島熊野道路
ひろしまきゅうじょう	広島球場
ひろしまきゅうしない	広島旧市内
ひろうひがたしゃかい	非浪費型社会
ひれいだいひょうせい	比例代表制
ひょうろんかくちょう	評論家口調
ひょうめんじょうたい	表面状態
ひょうめんけいじょう	表面形状
ひょうめんきょうかい	表面境界
ひょうほんてんちょう	標本点長
ひょうほんかこうぞう	標本化構造
ひょうちゅうていせい	標註訂正
ひょうちゃくぶったい	漂着物体
ひょうそうかんきょう	表層環境
ひょうじゅんろしゅつ	標準露出
ひょうじゅんぶったい	標準物体
ひょうじゅんひょうき	標準表記
ひょうじゅんはつおん	標準発音
ひょうじゅんにほんご	標準日本語
ひょうじゅんとくてん	標準得点
ひょうじゅんとうさい	標準搭載
ひょうじゅんてつづき	標準手続き	標準手続
ひょうじゅんたいけい	標準体型
ひょうじゅんぜいりつ	標準税率
ひょうじゅんじっそう	標準実装
ひょうじゅんざひょう	標準座標
ひょうじゅんごいがい	標準語以外
ひょうじゅんこうせい	標準構成
ひょうじゅんげんぞう	標準現像
ひょうじゅんけいしき	標準形式
ひょうじゅんきくかん	標準軌区間
ひょうじゅんかんすう	標準関数
ひょうじゅんかつどう	標準活動
ひょうじゅんかいしき	標準化意識
ひょうじてきいみろん	表示的意味論
ひょうじしゅうはすう	表示周波数
ひょうじがめんいどう	表示画面移動
ひょうじかのうしょく	表示可能色
ひょうしょうけいけん	表彰経験
ひょうしけんかんとう	表紙兼巻頭
ひょうげんのうりょく	表現能力
ひょうげんぎょうれつ	表現行列
ひょうげんかのうせい	表現可能性
ひょうけいさんきのう	表計算機能
ひゃくまんえんぜんご	百万円前後
ひゃくにんひゃくよう	百人百様
ひゃくすうじゅうにん	百数十人
ひゃくしゃくかんとう	百尺竿頭
ひぼうりょくていこう	非暴力抵抗
ひへいこうじょうたい	非平衡状態
ひびやせんちょくつう	日比谷線直通
ひひょうじゅんろんり	非標準論理
ひばくせんりょうけい	被曝線量計
ひはんてきしゅちょう	批判的主張
ひのでじょしがくえん	日出女子学園
ひどうきしきつうしん	非同期式通信
ひどうきしきけいさん	非同期式計算
ひとみきねんこうどう	人見記念講堂
ひとつきいじょうまえ	一月以上前
ひてんしゃりょういき	非転写領域
ひていじょうそうおん	非定常騒音
ひづけそうさかんすう	日付操作関数
ひつようさいていげん	必要最低限
ひつようかんきりょう	必要換気量
ひつぜんてきうんめい	必然的運命
ひだんせいしょうとつ	非弾性衝突
ひたんちょうすいろん	非単調推論
ひたちけんきゅうじょ	日立研究所
ひたちけんきゅうしょ	日立研究所
ひぜんやまぐちいえん	肥前山口以遠
ひせんけいげんしょう	非線型現象
ひせんけいけんきゅう	非線型研究
ひじょうにんりじこく	非常任理事国
ひじょうじげんそくど	非常時減速度
ひじょうしょくりょう	非常食糧
ひじょうしゅだんよう	非常手段用
ひじゅんせいたいせい	非純正体制
ひしょきかりょういき	非初期化領域
ひししょくぶつあもん	Angiospermae	被子植物亜門
ひこうきりようきゃく	飛行機利用客
ひこうかいじょうほう	非公開情報
ひけっていてきどうさ	非決定的動作
ひがしやまさんじょう	東山三条
ひがしやまきたおおじ	東山北大路
ひがしやまいまでがわ	東山今出川
ひがしむらやましみん	東村山市民
ひがしほんがんじまえ	東本願寺前
ひがしじょうもんじん	東縄文人
ひかんぜいしょうへき	非関税障壁
ひかりつうしんりろん	光通信理論
ひかくたいしょうれい	比較対象例
ひかぎゃくあっしゅく	非可逆圧縮
ひかがくてきこんきょ	非科学的根拠
ひかいいんりょうきん	非会員料金
はんわじどうしゃどう	阪和自動車道
はんりゅうしちょぞう	反粒子貯蔵
はんようきのうぶひん	汎用機能部品
はんべつしきかんすう	判別式関数
はんべつしきかいせき	判別式解析
はんのうだんめんせき	反応断面積
はんのうせんたくせい	反応選択性
はんどうたいぎじゅつ	半導体技術
はんどうたいかんけい	半導体関係
はんどうたいかいはつ	半導体開発
はんとしいじょうまえ	半年以上前
はんとうめいとりょう	半透明塗料
はんだんりょくひはん	判断力批判
はんだいつうしんこう	阪大通信工
はんだいきょうようぶ	阪大教養部
はんぞうもんせんよう	半蔵門線用
はんせいふせいりょく	反政府勢力
はんせいふしゅぎしゃ	反政府主義者
はんじみんとうひょう	反自民党票
はんしんひゃっかてん	阪神百貨店
はんしんだいしんさい	阪神大震災
はんしんけいばじょう	阪神競馬場
はんしゃめんだんめん	反射面断面
はんこうきょうきかん	半公共機関
はんきゅうみかげえき	阪急御影駅
はんきゅうにしのみや	阪急西宮
はんきゅうとっきゅう	阪急特急
はんきゅうせんりせん	阪急千里線
はんきゅうさんのみや	阪急三宮
はんきゅうこうべせん	阪急神戸線
はんきゅううめだえき	阪急梅田駅
はんきゅういまづせん	阪急今津線
はんかくにゅうりょく	半角入力
はんかいぎょうきのう	半改行機能
はんえいきゅうきかん	半永久機関
はままつきゅうじょう	浜松球場
はままついかだいがく	浜松医科大学
はまだじどうしゃどう	浜田自動車道
はなぞのしゅつじょう	花園出場
はつばいよていひょう	発売予定表
はつばいじょうきょう	発売状況
はつしょうがいせいは	初障害制覇
はつしゅつじょうこう	初出場校
はつしゅっしいちらん	初出誌一覧
はつかんぷうしょうり	初完封勝利
はつかんとうしょうり	初完投勝利
はっぴょうれんしゅう	発表練習
はっぴょうよていしゃ	発表予定者
はっぴょうもうしこみ	発表申込
はっぴょうてんじかい	発表展示会
はっぴょうしゃしめい	発表者氏名
はっぴょうけっていご	発表決定後
はっぴょうきぼうしゃ	発表希望者
はってんとちゅうこく	発展途中国
はってんとじょうこく	発展途上国
はってんてきかいさん	発展的解散
はってんてきかいけつ	発展的解決
はっちゃくりょうほう	発着両方
はっせいじょうきあつ	発生蒸気圧
はっしょくげんしょう	発色現象
はっしゃじこくひょう	発車時刻表
はっこうてすうりょう	発行手数料
はっこうじょうきょう	発行状況
はっこうしゅうりょう	発酵終了
はちのへこうだいいち	八戸工大一
はちじゅうはっかしょ	八十八箇所
はちじゅうにぎんこう	八十二銀行
はちおうじひがしこう	八王子東高
はしらとりつけかなぐ	柱取付金具
はしもとりゅうたろう	橋本龍太郎
はこねとざんてつどう	箱根登山鉄道
はこだてけいばじょう	函館競馬場
はぐるましきてつどう	歯車式鉄道
はくりょくじゅうぶん	迫力充分
はくぶつかんかいかん	博物館開館
はくつるびじゅつかん	白鶴美術館
はくしょくえきしょう	白色液晶
はくしがくいろんぶん	博士学位論文
はかせがくいろんぶん	博士学位論文
はかいてきだいにゅう	破壊的代入
はいれつがたへんかん	配列型変換
はいそうてすうりょう	配送手数料
はいぜんしゅうりょう	配膳終了
はいせんしようりょう	配線使用料
はいしたいしょうせん	廃止対象線
はいぐうしゃわりびき	配偶者割引
はいぐうしゃせんたく	配偶者選択
はいぐうしゃこうじょ	配偶者控除
はいきりょうへんこう	排気量変更
はいきおんどけいこく	排気温度警告
ほんぺんしゅうりょうご	本編終了後
ほんのうてきよっきゅう	本能的欲求
ほんしゃぎじゅつぶもん	本社技術部門
ほんごうゆうびんきょく	本郷郵便局
ほんこんとうきょうかん	香港東京間
ほんこんえいがたいかい	香港映画大会
ほんけんきゅうじょない	本研究所内
ほんきょちきゅうじょう	本拠地球場
ほんがくしゅうほうほう	本学習方法
ほっかいどうとくしゅう	北海道特集
ほっかいどうじゅうだん	北海道縦断
ほしょうでんりょくげん	補償電力源
ほしょうせいきゅうけん	補償請求権
ほしょうがたほちょうき	補償型補聴器
ほこうしゃようしんごう	歩行者用信号
ほけんきのうしょくひん	保健機能食品
ほくりくじどうしゃどう	北陸自動車道
ほくべいきょじゅうしゃ	北米居住者
ほくだいじょうほうこう	北大情報工
ほくだいこうどうかがく	北大行動科学
ほうわすいじょうきあつ	飽和水蒸気圧
ほうでんしゅうりょうじ	放電終了時
ほうてきこうそくりょく	法的拘束力
ほうていでんせんびょう	法定伝染病
ほうていせいげんそくど	法定制限速度
ほうそうだいがくこうざ	放送大学講座
ほうそうしゅうりょうじ	放送終了時
ほうそうしゅうりょうご	放送終了後
ほうそうきょくようきき	放送局用機器
ほうせんほうこうそくど	法線方向速度
ほうしゅつきゅうしゅう	放出吸収
ほうしゃそしきさいぼう	放射組織細胞
ほうしゃせんりょうほう	放射線療法
ほうしゃせんしょうがい	放射線障害
ほうしゃせいはいきぶつ	放射性廃棄物
ほうしゃせいどういたい	放射性同位体
ほうしゃせいこうかぶつ	放射性降下物
ほうしゃせいかごうぶつ	放射性化合物
へんびぶんほうていしき	偏微分方程式
へんしゅうはっこうにん	編集発行人
へんしゅうちょさくぶつ	編集著作物
へんしゅうちょさくけん	編集著作権
へんしゅうせきにんしゃ	編集責任者
へんしゅうきょくちょう	編集局長
へんしゅういいんちょう	編集委員長
へんこうせいぶんかかい	変光星分科会
へんこうしんせいちゅう	変更申請中
へいれつぶんさんしょり	並列分散処理
へいれつびょうがきのう	並列描画機能
へいれつしょりぎじゅつ	並列処理技術
へいめんふたまたぶんし	平面二又分枝
へいせつこうしゅうかい	併設講習会
へいしょきょうふしょう	claustrophobia	閉所恐怖症
へいこうせんじょうたい	平行線状態
へいこうけいさんりろん	並行計算理論
へいこうかくかんきょり	平衡核間距離
へいきんすいみんじかん	平均睡眠時間
へいきんじょうしゃりつ	平均乗車率
へいきんじゆうこうてい	平均自由行程
へいきんおうとうじかん	平均応答時間
ふりかえけっさいせいど	振替決済制度
ふほうげんいんきゅうふ	不法原因給付
ふびょうどうじょうやく	不平等条約
ふどうしょうすうてんち	浮動小数点値
ふどうさんしんだつざい	不動産侵奪罪
ふどうさんしゅとくぜい	不動産取得税
ふつうめんきょしゅとく	普通免許取得
ふつうにゅうじょうけん	普通入場券
ふつうしゃきんえんせき	普通車禁煙席
ふっこうきょうちりょう	腹腔鏡治療
ふっきゅうじょうきょう	復旧状況
ふたごたまがわえんえき	二子玉川園駅
ふたござりゅうせいぐん	双子座流星群
ふじゅんいせいこうゆう	不純異性交遊
ふじむらじょしこうこう	藤村女子高校
ふじつうじょうほうけん	富士通情報研
ふじつうけんきゅうしょ	富士通研究所
ふじしえいきゅうじょう	富士市営球場
ふじいでらきゅうじょう	藤井寺球場
ふくはんぎゃくどうめい	服反逆同盟
ふくそへいめんぜんたい	複素平面全体
ふくすうかんりにんせい	複数管理人制
ふくしまだいにげんぱつ	福島第二原発
ふくごうどうきしんごう	復号同期信号	複合同期信号
ふくごうごぜんへんかん	複合語全変換
ふくごうきごうこうぞう	複合記号構造
ふくおかあさひほうそう	福岡朝日放送
ふくいけんりつだいがく	福井県立大学
ふかくていせいかんけい	不確定性関係
ふうぞくえいぎょうよう	風俗営業用
ふうぞくえいぎょうほう	風俗営業法
ふあんていきょうしんき	不安定共振器
ひんしつじょうほうしつ	品質情報室
ひろしましりつだいがく	広島市立大学
ひれいぼうしゃへんせい	非冷房車編成
ひらまくゆうしょうしゃ	平幕優勝者
ひらつかきょうぎじょう	平塚競技場
ひらかわしゅっぱんしゃ	平河出版社
ひょうろんかれんちゅう	評論家連中
ひょうめんはんのうほう	表面反応法
ひょうめんちょうりょく	表面張力
ひょうていしゃくどほう	評定尺度法
ひょうじゅんそうちゃく	標準装着
ひょうじゅんがたりろん	標準型理論
ひょうじゅんかんきょう	標準環境
ひょうじゅんかほうしん	標準化方針
ひょうじゅんかどうこう	標準化動向
ひょうじゅんかだんたい	標準化団体
ひょうじゅんかじぎょう	標準化事業
ひょうじゅんかかつどう	標準化活動
ひょうじゅんかかくまい	標準価格米
ひょうげんりょくぶそく	表現力不足
ひょうきこうしゅうかい	標記講習会
ひょうかけんきゅうしつ	評価研究室
ひゆーくりっどきかがく	非ユークリッド幾何学
ひゃっぱつひゃくちゅう	百発百中
ひへいわてきじょうたい	非平和的状態
ひぶんせきてきしゅほう	非分析的手法
ひひょうじゅんかいせき	非標準解析
ひとうぶんへいきんりつ	非等分平均率
ひていひょうじゅんけい	否定標準形
ひつようじゅうぶんせい	必要十分性
ひつようさいていげんど	必要最低限度
ひつようさいしょうげん	必要最小限
ひだりかんやくほうそく	左簡約法則
ひたちかせいこうぎょう	日立化成工業
ひたいしょうほうけいは	非対称方形波
ひたいしょうぎょうれつ	非対称行列
ひじょうゆそうたいせい	非常輸送態勢
ひじょうほうけいがっか	非情報系学科
ひじつりょくはせんげん	非実力派宣言
ひさいしゅうじょうたい	非最終状態
ひこうふのうじょうたい	飛行不能状態
ひこうじょうのうりょく	飛行場能力
ひがしはりだしせきわけ	東張出関脇
ひがしはりだしおおぜき	東張出大関
ひがしにほんだいひょう	東日本代表
ひがしなだしんごうじょ	東灘信号所
ひがしなだしんごうしょ	東灘信号所
ひがしじゅうじょうかん	東十条間
ひがしかいがんりょこう	東海岸旅行
ひかりつうしんほうしき	光通信方式
ひあっしゅくりょういき	非圧縮領域
ひあっしゅくせいきたい	非圧縮性気体
はんようちょうへいれつ	汎用超並列
はんばいさいていかかく	販売最低価格
はんどうたいじぎょうぶ	半導体事業部
はんどうたいさんぎょう	半導体産業
はんどうたいけんきゅう	半導体研究
はんどうたいぎじゅつぶ	半導体技術部
はんだいじょうほうこう	阪大情報工
はんたいとうひょうすう	反対投票数
はんたいしょうほうそく	反対称法則
はんそくきんかりのうふ	反則金仮納付
はんしんりゃくせんそう	反侵略戦争
はんしんでんきてつどう	阪神電気鉄道
はんしんだいしょうてん	阪神大賞典
はんしゃぼうえんきょう	反射望遠鏡
はんしゃかいてきこうい	反社会的行為
はんしちとりものちょう	半七捕物帳
はんきゅういしばしえき	阪急石橋駅
はんかくえいすうこてい	半角英数固定
はんかくえいじへんかん	半角英字変換
はんえいきょうかいない	半影境界内
はらじゅくえきほうこう	原宿駅方向
はままつじょうこうえん	浜松城公園
はままつしみんかいかん	浜松市民会館
はままつしたいいくかん	浜松市体育館
はままつきゅうぎじょう	浜松球技場
はつばいびそくかんばい	発売日即完売
はつばいしゅうりょうご	発売終了後
はつとうじょうおんげん	初登場音源
はつえいぎょううんてん	初営業運転
はっぴょうしゅうりょう	発表終了
はっぴょうしゃぼしゅう	発表者募集
はってんとじょうちゅう	発展途上中
はってんてきかいしょう	発展的解消
はったつしんりがくしゃ	発達心理学者
はっせいじょうきりょう	発生蒸気量
はっしんせんようでんわ	発信専用電話
はっけんてきがくしゅう	発見的学習
はっきんせんでんきょく	白金線電極
はちのへこうぎょうだい	八戸工業大
はちおうじどうぶつえん	八王子動物園
はくひんかんげきじょう	博品館劇場
はくばのりくらこくさい	白馬乗鞍国際
はかせへんにゅうしけん	博士編入試験
はいそうようしゃりょう	配送用車輌
はいしゃしょうめいしょ	廃車証明書
ほんせんしゅつじょうけん	本戦出場権
ほんこんこくさいけいさつ	香港国際警察
ほんこんけいとくくうこう	香港啓徳空港
ほんけんきゅうしゅうかい	本研究集会
ほんかくすいりしょうせつ	本格推理小説
ほろいわやまてんぼうだい	幌岩山展望台
ほっぽうよんとうえんがん	北方四島沿岸
ほっそくきねんしゅうかい	発足記念集会
ほっかいがくえんだいがく	北海学園大学
ほしょうにんていばんごう	保証認定番号
ほしょうかんすうせってい	補償関数設定
ほくそうかいはつてつどう	北総開発鉄道
ほうわすいじょうきりょう	飽和水蒸気量
ほうりつそうだんばんぐみ	法律相談番組
ほうやくはっぴょうじゅん	邦訳発表順
ほうていがいもくてきぜい	法定外目的税
ほうしゅうせいきゅうけん	報酬請求権
ほうしゃそしきかどうかん	放射組織仮導管
ほうこうけっていたいいき	方向決定帯域
ほうがくぶしゅっしんしゃ	法学部出身者
へいわかいほうじょうやく	平和解放条約
へいれつぶったいにんしき	並列物体認識
へいれつしょりけんきゅう	並列処理研究
へいめんじょうにさぶんし	平面状二叉分枝
へいせいちくほうてつどう	平成筑豊鉄道
へいきんりようきゃくすう	平均利用客数
へいきんにっしょうじかん	平均日照時間
へいきんきつえんほんすう	平均喫煙本数
ふるかわでんきこうぎょう	古河電気工業
ふどうしょうすうてんすう	浮動小数点数
ふどうしょうすうてんがた	浮動小数点型
ふつうりょきゃくうんちん	普通旅客運賃
ふつううんちんりょきゃく	普通運賃旅客
ふごうかくちょうほうしき	符合拡張方式
ふくすうひょうとうひょう	複数票投票
ふくしょうそうひょうすう	複勝総票数
ふがくさんじゅうろっけい	富嶽三十六景
ひろだいおうようりきがく	広大応用力学
ひらまくゆうしょうりきし	平幕優勝力士
ひよしほうめんちょくつう	日吉方面直通
ひょうほんかしゅうはすう	標本化周波数
ひょうじゅんにゅうりょく	標準入力
ひょうじゅんてきぶんたい	標準的文体
ひょうじゅんしゅつりょく	標準出力
ひょうじゅんしごとりょう	標準仕事量
ひょうじゅんこうりかかく	標準小売価格
ひょうじゅんかしぼうりつ	標準化死亡率
ひょうじゅんかいいんかい	標準化委員会
ひめじどっきょうだいがく	姫路独協大学	姫路獨協大学
ひびややがいおんがくどう	日比谷野外音楽堂
ひていじょうかんきょうか	非定常環境下
ひちょうようかんこくじん	被徴用韓国人
ひきょうせいれんこうしゃ	被強制連行者
ひがしとうきょうたいかい	東東京大会
ひがしかいがんりょうきん	東海岸料金
ひかりしゅうせきこうがく	光集積工学
ひかりこうかんけんきゅう	光交換研究
ひかりきのうざいりょうぶ	光機能材料部
はんだんひかくざいりょう	判断比較材料
はんだいせんぱくかいよう	阪大船舶海洋
はんだいきゅうきょうよう	阪大旧教養
はんじゅうりょくぶっしつ	反重力物質
はんしゃかいてきじんぶつ	反社会的人物
はんきょうていいしんごう	反響定位信号
はんきゅうたからづかせん	阪急宝塚線
はんきゅうきたせんりえき	阪急北千里駅
はんかんきょうほぜんてき	反環境保全的
はんかくえいすうきりかえ	半角英数切替
はらじゅくえきしゅうごう	原宿駅集合
はやかわでんきこうぎょう	早川電機工業
はつばいもとれんらくさき	発売元連絡先
はつばいじゅんえんちゅう	発売順延中
はっぴょうもうしこみすう	発表申込数
はっぴょうもうしこみさき	発表申込先
はっぴょうかのうていいん	発表可能定員
はっせいてきにんしきろん	発生的認識論
はちおうじりょうきんじょ	八王子料金所
はしうえとうけつちゅうい	橋上凍結注意
はくぶつかんどうぶつえん	博物館動物園
はくじんせんようれっしゃ	白人専用列車
はかいかつどうぼうしほう	破壊活動防止法
ほんぶんぜんぶしょうりゃく	本文全部省略
ほっかいどうかいはつちょう	北海道開発庁
ほくりくほんせんとっきゅう	北陸本線特急
ほうそうこうきょうがくだん	放送交響楽団
ほうしゃたいりゅうへいこう	放射対流平衡
ほうしゃせんけんきゅうしつ	放射線研究室
へんしつきょうてきせいかく	偏執狂的性格
へんけいろうどうじかんせい	変形労働時間制
へいこうゆにゅうぎょうしゃ	並行輸入業者
へいきんどうにゅうだいすう	平均導入台数
へいきんじじょうよそうごさ	平均二乗予想誤差
ふたまたじょうかじくぶんし	二又状仮軸分枝
ふせいきょうそうぼうしほう	不正競争防止法
ふくごうじんたいそんしょう	複合靭帯損傷
ふくごうざいけんきゅうじょ	複合材研究所
ふくおかこうぎょうだいがく	福岡工業大学
ふくおかきょういくだいがく	福岡教育大学
ひろしましゅうどうだいがく	広島修道大学
ひろしましみんきゅうじょう	広島市民球場
ひろしまけんふちゅうちょう	広島県府中町
ひょうじゅんびせいぶつがく	標準微生物学
ひょうじゅんきようしゃりん	標準軌用車輪
ひょうじゅんおんがくじてん	標準音楽辞典
ひょうげんかのうせいていり	表現可能性定理
ひせんけいごうせいほうしき	非線型合成方式
ひせんけいかへんらんくほう	非線型可変ランク法
ひがしとうきょうだいひょう	東東京代表
ひかりつうしんけんきゅうぶ	光通信研究部
はんようへいれつけいさんき	汎用並列計算機
はんどうたいけんきゅうじょ	半導体研究所
はんしんあわじだいしんさい	阪神淡路大震災	阪神・淡路大震災
はんきゅうでんしゃおおみや	阪急電車大宮
はんきゅうしじょうおおみや	阪急四条大宮
はんがしゅっぱんぎょうしゃ	版画出版業者
はままつしょくくんたんだい	浜松職訓短大
はままつしえいきゅうじょう	浜松市営球場
はつしゅつじょうゆうしょう	初出場優勝
はっぴょうもうしこみひょう	発表申込票
はちのへこうぎょうだいがく	八戸工業大学
はちおうじじっせんこうこう	八王子実践高校
はいたてきけいざいすいいき	排他的経済水域
ほうえいしゅうりょうちょくご	放映終了直後
へいめんじょうふたまたぶんし	平面状二又分枝
へいきんちょくりゅうでんあつ	平均直流電圧
ふどうしょうすうてんていすう	浮動小数点定数
ふくごうきょうどうじゅうたく	複合共同住宅
ひらかなかくていにゅうりょく	平仮名確定入力
ひょうじゅんてききょうかしょ	標準的教科書
ひょうじゅんさいきょうそうび	標準最強装備
ひょうきけんきゅうしゅうかい	標記研究集会
ひとつばしだいじょきょうじゅ	一橋大助教授
ひつようじゅうぶんじょうけん	必要十分条件
ひかりこうがくけんきゅうしつ	光工学研究室
はんきゅうにしのみやきたぐち	阪急西宮北口
はんきゅうせんじゅうそうえき	阪急線十三駅
はんかくえいすうにゅうりょく	半角英数入力
はままつしょくぎょうたんだい	浜松職業短大
はっぴょうもうしこみしめきり	発表申込締切
はっぴょうもうしこみあんない	発表申込案内
はいぐうしゃとくべつこうじょ	配偶者特別控除
ほうしゃせんかんりけんきゅうぶ	放射線管理研究部
ほうけいほうしゃそしきさいぼう	方形放射組織細胞
へんびぶんほうていしきもんだい	偏微分方程式問題
へいふくほうしゃそしきさいぼう	平伏放射組織細胞
ひょうじゅんにゅうしゅつりょく	標準入出力
ひょうしょうしきしゅうりょうご	表彰式終了後
ひだんせいさんらんだんめんせき	非弾性散乱断面積
ひかりじょうほうけんきゅうしつ	光情報研究室
はんぷくうんどうかたそんしょう	反復運動過多損傷	Repetitive Strain Injury	RSI
ひていひょうじゅんけいろんりしき	否定標準形論理式
はままつしょくぎょうくんれんたんだい	浜松職業訓練短大
ほくりくせんたんかがくぎじゅつだいがくいんだいがく	北陸先端科学技術大学院大学
