の	陳	濃	−	呑	乗	述	嚥	伸	乃	之	飮	迯	乘	徐	載	飲	野	埜	退	廼	熨	延	逃	除
ね	寢	子	煉	禰	練	音	捩	袮	寝	錬	祢	嶺	睨	捻	根	値	粘	涅
ぬ	塗	貫	拔	奴	抜	縫	怒	脱	濡
に	丹	弍	爾	2	荷	似	尼	仁	迯	貮	煮	迩	貳	２	邇	二	弐	児	逃	岻
な	啼	撫	痿	失	名	亡	泣	慣	菜	萎	薙	狎	爲	嚶	哭	嘗	奈	綯	為	鳴	凪	生	儺	並	熟	南	馴	投	涕	做	娜	舐	拿	那	無	成	納	啾	茄	竝
のろ	咒	麕	野呂	詛	鈍	呪
のり	教	弼	法	範	乗り	徳	則	悳	典	海苔	雅	矩	紀	規範	朔	規	就	哲	宜	糊	昇	伯	憲	孔
のら	野良
のや	野焼
のも	野茂
のみ	蚤	能美	鑿	乃美
のま	々	野間
のぼ	騰	登	昇	逆上	上
のべ	野邊	延べ	野辺
のぶ	信	亘	允	順	宣	展	伸	暢	惟	修	延
のび	伸	野火
のば	野場	延
のの	野々	罵
のど	咽	喉
のと	能登	能都
ので	野出
のづ	野積
のつ	野津
のち	後
のだ	野田
のぞ	臨	覗	覘	望	除
のせ	能勢	野瀬	能瀬
のじ	野地	野路
のし	熨斗	熨
のこ	遺	鋸	残	殘
のげ	野毛
のぎ	芒	禾	野義	乃木	野木
のき	軒
のが	遁	逸	迯	逃
のえ	野家
のう	濃	膿	皇	嚢	獰	碯	曩	能	衲	農	悩	能生	腦	瑙	王	惱	納	脳
ねん	棯	年	念	撚	然	燃	拈	捻	稔	粘
ねり	練り	練
ねら	狙
ねや	寝屋	閨
ねむ	睡	眠	合歓
ねま	寝間
ねぼ	寝惚	寝呆
ねぶ	舐	合歓	値踏
ねび	寝冷	値引
ねば	根羽	粘
ねな	根無
ねと	寝泊	寝取
ねづ	根津	禰津	根詰	根付
ねつ	寝付	捏	熱
ねっ	熱	根っ
ねだ	強請	根太	寝溜
ねた	妬
ねず	根津	禰津	杜松
ねす	寝過
ねじ	捩子	拗	螺	捩	螺子	捻子	捻
ねざ	根差	寝覚
ねさ	値下
ねこ	猫	寝込
ねぎ	葱	値切
ねが	願
ねお	根緒	寝起	根尾
ねえ	姉
ねう	値打
ねい	侫	禰	寧	聹	嚀	祢	檸	濘	佞	寝入
ねあ	値上	寝明
ぬれ	濡れ
ぬる	微温	温
ぬり	塗
ぬめ	滑	絖
ぬま	沼
ぬひ	奴婢
ぬの	布
ぬた	饅	垈
ぬす	盗	盜
ぬし	主
ぬさ	幣	帛
ぬけ	抜	抜け	脱
ぬぐ	拭
ぬく	温
ぬき	貫	緯	擢	抽	抜き
ぬか	泥濘	額	糠
ぬえ	鵺
にん	儿	刃	忍	刄	姙	仁	妊	認	人	任
にわ	二羽	二話	丹羽	俄	庭
にれ	楡
にら	眈	韮	薤	睨	韭
にょ	女	如	汝
にぼ	煮干
にほ	二歩
にべ	仁部	鰾膠
にぶ	二部	II部	2部	鈍	二分
にふ	２符	二夫	二歩
にひ	二飛
には	二派	二波
にぬ	煮抜
にな	担	螺	蜷	擔
にど	二度
にと	二兎	二途
にて	二手
につ	煮付	煮詰
にち	二値	2値	日
にだ	荷駄	煮出
にた	煮炊	仁多	煮立
にせ	偐	贋	僞	偽
にじ	躙	二字	二次	尼寺	2時	二児	2次	二時	虹	２次	滲
にし	煮染	螺	西	爾志	二死
にさ	二叉
にご	濁	二語
にこ	2個	二個	二胡	煮込	柔	和
にげ	逃げ
にく	難	憎	肉
にぎ	握	賑
にき	煮切	仁木	二基	二木
にが	苦	逃
にか	二価	二課
にお	匂	臭	仁尾	鳰
にえ	煮え	錵	沸	贄
にい	新	兄	二位	新居
にあ	荷揚	似合
なん	娚	楠	難	男	南	軟	喃	何	納
なわ	繩	苗	名和	縄
なれ	熟れ	馴	慣れ
なる	徳	鳴	奈留	成
なり	哉	就	也	斉	鳴り	形	成
なら	列	肄	慣	楢	双	柞	均	並	枹	平城	習	奈良	倣	竝
なよ	名寄
なゆ	那由
なや	納屋	悩	納谷	惱
なめ	嘗	滑	鞣
なむ	南無
なみ	浪	奈未	名美	波	奈巳	並	奈美	〜	竝
なま	譌	怠	懶	訛	生	鈍
なほ	猶	菜穂	尚	直	治
なべ	邊	鍋	辺	邉	並べ
なぶ	嬲	嫐
なび	靡
なは	話	那覇
なの	名乗	nano	名告	名宣	七
なに	何
なな	奈々	名無	７	七	斜	奈奈
など	等
なづ	泥	名付
なつ	夏	懐	捺	懷	奈津
なっ	納
なち	那智
なだ	宥	灘	傾	雪崩	名立
なた	釶	屶	鉈
なぞ	謎
なぜ	名瀬	何故
なせ	奈瀬
なず	泥
なす	茄子	那須	那州	擦	茄
なじ	詰	馴染
なし	梨	無し	無
なざ	名指
なさ	情
なご	名残	名護	名子	名古	和
なこ	名古
なげ	無げ	嘆	投げ	慨	歎
なけ	泣け
なぐ	撲	殴	薙	薙ぐ	擲	毆
なぎ	薙	南木	奈義	凪	椥	梛
なき	泣き	鳴	亡き
なが	眺	乍	存	永	流	長
なか	勿	那珂	仲	中	半
なお	奈緒	癒	猶	菜穂	尚	直	奈央	治
なえ	苗	奈江
なう	名う
ない	内	乃	無
のんき	暖気	暢気	呑気
のわき	野分
のろし	狼煙	烽火	烽	燧
のろけ	惚気
のろい	呪い
のれん	暖簾
のりよ	記代
のりや	法也	紀哉
のりほ	範穂
のりば	乗場	乗り場
のりと	祝詞
のりて	乗り手
のりづ	糊付
のりつ	乗り付	乗り継
のりだ	乗り出
のりす	乗り捨
のりこ	乃梨子	範子	能理子	賀子	紀子	乗り込	訓子	徳子	のり子	典子	則子	倫子	教子	法子	乗り越	規子	祈子
のりく	乗り組
のりき	乗り切	乗り気
のりか	乗換	乗り掛	乗り替	乗り換
のりお	典夫	紀男	展男	徳雄	昇男	憲雄	則夫	典男	憲生	典生	憲夫	則郎	範夫	紀夫
のりえ	礼江	法枝
のりい	乗り入
のりあ	乗り合
のらぎ	野良着
のやま	野山
のやき	野焼	野焼き
のもと	野本
のむら	乃村	野村
のむぎ	野麦
のみや	飲み屋	呑屋	飮み屋	呑み屋	野宮
のみほ	飲み乾	飲み干
のみて	飲み手
のみず	野水
のみす	飲み過
のみこ	飲込	飲み込	呑み込
のみあ	飲む明	飲み明
のまち	野町
のぼる	登	昇
のぼり	幟	登	上り
のほり	野堀
のほう	野放	野方
のべな	野辺名
のへん	野辺
のへじ	野辺地
のぶん	攵
のぶや	信也	誠也	暢也
のぶた	信太
のぶじ	伸自	伸治
のぶし	野武士	野伏	野臥
のぶこ	暢子	延子	信子	敦子	伸子	展子
のぶき	信木	伸樹	信樹
のぶお	信夫	暢夫	信雄	陳雄	宣夫	信朗	信生	伸夫	信男	伸生
のぶえ	伸枝	信恵	延枝
のふせ	野伏
のびる	野蒜
のびと	野人
のびた	のび太
のびき	延び切	伸び切
のびあ	伸び上
のひら	野平
のばら	野薔薇
のばな	野放	野花
のばと	野鳩
のばす	〜〜〜〜〜〜〜〜
のばし	伸ばし
のはら	野原
ののし	罵
ののか	野々香
のねこ	野猫
のなみ	野並
のなか	野中	野仲
のどか	長閑
のとろ	能取
のでら	野寺
のてん	野天
のてう	盧泰愚
のづら	野面
のづみ	野積み
のづき	野月
のっと	乗っ取	則	祝詞
のちぞ	後添
のだて	野点
のだし	野田市
のたれ	湾
のたま	宣	曰
のぞむ	望
のぞみ	稀	希	望	望み
のぞき	覗
のぞえ	野添	野副
のずえ	野末
のじん	野人
のじり	野尻
のじま	野島	野嶋
のしろ	能城	能代	野城
のしめ	熨斗目
のした	野下
のしあ	伸し上
のざわ	野沢	野澤
のざる	野猿
のざら	野晒
のざと	野里
のざき	野咲	野崎
のさか	野栄	野坂
のこり	残り
のけぞ	のけ反	仰け反
のぐら	野倉
のぐち	野口
のぐそ	野糞
のくび	野首
のぎわ	野際
のぎし	野岸
のぎく	野菊
のきば	軒端
のきな	軒並
のがわ	野川	野河
のがみ	野上	埜上
のがた	野方
のがき	野垣
のかみ	野上
のかた	野方
のかぜ	野風
のえる	Ｎｏёｌ
のうり	能吏	脳裡	脳裏
のうむ	濃霧
のうみ	能見	能美
のうほ	農圃
のうふ	農婦	納付	農夫
のうび	濃尾
のうは	脳波
のうな	能無
のうど	農奴	濃度
のうち	農地	納地	野内
のうだ	納田
のうじ	能地	農事	能事
のうし	直衣	野牛	脳死
のうぐ	農具
のうき	納期	納城	農機	農期
のうか	濃化	農家
のいち	野市
のいけ	野池
のーと	帳面
ねんり	年利
ねんよ	年余
ねんめ	年目
ねんぷ	年賦	年譜
ねんぴ	燃費
ねんぱ	念波
ねんど	粘土	年度	粘度
ねんじ	年次	年時
ねんし	念死	年始	撚糸
ねんざ	捻挫
ねんさ	年差
ねんご	年後	懇
ねんぐ	年貢
ねんき	年忌	年紀	年季	年期
ねんが	年賀
ねんお	念押
ねんい	念入
ねわら	寝藁
ねわざ	寝技
ねわけ	根分け
ねりま	練馬
ねりこ	練り込
ねりえ	煉餌	練り餌	煉り餌
ねらい	狙い
ねゆき	根雪
ねもと	根元	根本
ねもこ	懇
ねめつ	睨め付
ねむろ	根室
ねむけ	眠気
ねみみ	寝耳
ねまわ	根回
ねまき	寝間着	寝巻	寝衣
ねぼけ	寝惚け
ねぼう	寝坊
ねほん	根本
ねぶみ	値踏み
ねぶと	根太
ねぶか	根深
ねふだ	値札
ねびき	値引き
ねびえ	寝冷え
ねばつ	粘着
ねはん	涅槃
ねはば	値幅
ねなし	根無し
ねどこ	寝床
ねづよ	根強
ねづけ	値付け
ねづか	根塚	寝疲
ねつど	熱度
ねつけ	熱気	根付け	根付
ねつぎ	根継ぎ
ねつき	値付き	寝付き
ねつか	熱価
ねつい	熱意
ねっぱ	熱波
ねっさ	熱砂
ねっこ	根っこ	根っ子
ねっき	熱気
ねっか	熱河
ねちが	寝違
ねだん	値段
ねだめ	寝溜め
ねぞう	寝相
ねずみ	子	鼠	鼡
ねすご	寝過
ねじろ	根白	根城
ねじめ	根締め	根占
ねじま	捩じ曲	捻じ曲
ねじふ	捻じ伏
ねじこ	捩じ込	ねじ込
ねじけ	拗け
ねじき	捩じ切
ねじあ	捩じ上
ねしち	根質
ねしず	寝静
ねざや	値鞘
ねざめ	寝醒め	寝覚め
ねざま	寝様
ねざし	根差し
ねざけ	寝酒
ねざき	根崎
ねさげ	値下	値下げ
ねごろ	値頃	根来
ねごや	根小屋
ねごと	寝言
ねころ	寝転
ねこめ	猫目
ねこま	猫間	猫魔
ねこべ	猫部
ねこは	猫派
ねこて	猫手
ねこた	猫田
ねこぜ	猫背
ねこず	猫好
ねこか	猫科
ねぐる	寝苦
ねぐら	塒
ねぐせ	寝癖
ねくら	根暗
ねくび	寝首
ねくず	値崩
ねぎわ	根際
ねぎり	値切り	値切
ねぎら	犒
ねぎま	葱鮪
ねぎし	根岸
ねぎか	葱科
ねがみ	根上
ねがさ	値がさ	値嵩
ねがお	寝顔
ねがえ	寝返
ねがい	願い	願
ねかぶ	根株
ねかた	根方
ねおん	Ne	Neon
ねおき	寝起き	寝起
ねえよ	寧代
ねえや	姉や
ねうち	値打	値打ち
ねうご	値動
ねいろ	音色
ねいは	寧波
ねいす	寝椅子
ねいし	根石
ねいき	寝息
ねいか	寧夏
ねあら	値洗
ねあせ	寝汗
ねあげ	値上げ	値上
ねあが	値上	根上
ぬれば	濡場	濡れ場
ぬれて	濡れ手
ぬるゆ	微温湯
ぬるま	微温
ぬりわ	塗り分
ぬりつ	塗り付
ぬりこ	塗り込
ぬりか	塗り替
ぬりえ	塗り絵
ぬまべ	沼部
ぬまづ	沼津
ぬまち	沼地
ぬまた	沼田
ぬまず	沼津
ぬまお	沼尾
ぬぼく	奴僕
ぬのめ	布目
ぬのじ	布地
ぬのき	布切
ぬのう	布売
ぬすむ	窃
ぬすみ	窃	盗み
ぬけめ	抜目	抜け目
ぬけに	抜荷	抜け荷
ぬけだ	抜け出
ぬけげ	抜け毛
ぬけが	抜け駆
ぬけお	抜け落
ぬくみ	温み
ぬくい	温い	貫井
ぬぎす	脱ぎ捨
ぬぎき	脱着
ぬきみ	抜身	抜き身
ぬきに	抜き荷	抜荷
ぬきと	抜き取
ぬきで	抜き出
ぬきて	抜手
ぬきだ	抜き出
ぬきず	抜き刷
ぬきさ	抜き去	抜き差
ぬきう	抜き打	抜打	抜き撃
ぬきい	貫井
ぬきあ	抜き合
ぬかる	泥濘
ぬかた	額田
ぬかご	糠子	零余子
ぬかか	糠蚊
ぬいめ	縫い目	縫目
ぬいつ	縫い付
ぬいだ	縫田
ぬいこ	縫い込
ぬいあ	縫い上
にんめ	人目
にんむ	任務
にんぷ	人夫	妊婦
にんぴ	認否
にんち	認知	任地
にんく	忍苦	人工
にんき	人気	任期
にんか	認可
にんい	任意	∀
にわり	二割
にわの	庭野
にわた	庭田
にわせ	庭瀬
にわし	庭師
にわき	庭木
にわか	仁輪加	俄か	俄
にろう	二浪
にれつ	二列
にれい	楡井
にるい	二類	二塁
にりん	二輪	２輪
にりつ	二律
にらみ	睨み
によど	仁淀
によう	二様	二葉
にょろ	〜
にょぜ	如是
にょし	女子
にょご	女御
にょう	獰	女	繞	尿
にょい	如意
にゅう	乳	ν	入	廿	柔
にやく	荷役	二役
にゃく	蒻	若
にもん	2問
にもの	煮物
にもつ	荷物
にもじ	二文字	2文字
にめん	二面
にめい	二名
にむら	二村
にみや	二宮
にまめ	煮豆
にまい	２枚	二枚
にぼし	煮干	煮干し
にほん	日本	二本
にほう	二方
にへん	二辺
にへい	仁平	二瓶
にぶん	2分	二分
にぶつ	二物
にふん	2分
にふだ	荷札
にふく	煮含
にひき	二匹
にばん	二番
にばい	二倍
にはん	二犯	二版
にはつ	二発
にはじ	煮始
にはく	二拍	二泊	2泊
にはか	俄
にはい	二敗	二杯
にのや	二の矢
にのへ	二戸
にのく	二の句
にねん	２年	二年	2年
にぬし	荷主
にぬけ	２抜け
にぬき	煮抜き	荷抜き
ににん	二人
にどめ	二度目
にどね	二度寝
にとべ	二藤部	新渡戸
にとお	二通
にとう	仁藤	二等	二頭
にてん	2点	二点
にづみ	荷積み
にづく	荷造
につま	煮詰
につけ	煮付け
につう	二通	2通
にった	仁田	新田
にっそ	日ソ
にっし	日誌
にっき	日揮	日記
にっか	日貨	日課	日華
にちわ	日和
にちろ	日露
にちや	日夜
にちめ	日目
にちぶ	日舞
にちじ	日次	日時
にちご	日後
にちが	日我
にちか	二千翔	二値化	2値化
にだん	二段
にだな	荷棚
にだし	荷出し
にだい	2大	荷台	二大	二台
にたみ	仁多見
にたに	二谷
にただ	仁多田
にたく	二択
にたき	煮炊き
にたい	二体
にそく	二足
にそう	二曹	二相	尼僧	二層
にせん	二錢	二千	二線
にせき	二関
にせい	二世	２声
にじる	煮汁
にじょ	二女
にじの	虹野
にじこ	虹子
にじく	二軸
にじき	二時期
にしん	二進	鯡	2進	二伸	鰊	二審
にしゅ	二種
にしや	西屋
にしゃ	二者	二社
にしめ	西目
にしむ	西向
にしほ	西穂
にしべ	西部
にしび	西日	西陽
にしの	西野
にしね	西根
にしな	西名	仁科
にしだ	西田
にしご	二死後	西語
にしく	西区
にしき	西紀	二式	西木	錦
にしお	西尾
にしい	西井
にさん	二、三	二三
にさつ	二冊
にごん	二言
にごう	二合	二号
にこん	耳根
にこみ	煮込	煮込み
にこげ	和毛
にこく	二国
にこう	2項	二高	二項
にげん	二元
にげば	逃げ場
にげだ	逃げ出
にげさ	逃げ去
にげこ	逃げ込
にげき	逃げ切
にげお	逃げ落
にげう	逃げ失
にけん	二件	二軒	２研	二間	二研
にぐん	二群	二軍
にぐら	荷鞍
にくや	肉屋
にくづ	肉付
にくず	荷崩	煮崩
にくげ	肉芽
にくが	肉芽
にくか	肉果
にぎわ	賑
にぎは	賑
にぎす	似鱚
にきり	煮切り
にきび	靤	面皰
にがん	二眼
にがわ	仁川
にがゆ	煮粥
にがみ	苦味	苦み
にがて	苦手
にがつ	如月	二月	2月	２月
にがさ	苦さ
にがき	苦木
にがお	似顔
にかん	二冠
にかわ	仁川	膠
にかよ	似通
にかほ	仁賀保
にかた	煮方
にかく	仁鶴
にかい	二階	2階	２回	２階	2回	二回
におぶ	Niobium	Nb
におし	二推し
におう	仁王
におい	匂	匂い	荷負
にえゆ	煮湯	煮え湯
にえた	煮え立
にえき	煮え切
にうま	荷馬
にうけ	荷受	荷受け
にいろ	丹色
にいみ	新實	新美	新実	新見
にいほ	新穂	仁保
にいべ	新部
にいな	二名
にいで	新出
にいつ	新津
にいだ	新田
にいざ	新座
にいい	新居
にあし	荷足
にあげ	荷揚げ
にあう	似合う
なんわ	何話
なんろ	難路
なんり	南里
なんら	何等	何ら
なんや	南谷
なんぽ	何歩
なんぶ	南部	南武	何部	軟部
なんぱ	軟派	難破
なんば	難場	難波
なんの	南野	何の
なんな	垂	難無
なんど	難度	納戸	何度
なんと	南都	南斗	何と
なんて	何て
なんち	難治
なんせ	何せ
なんじ	爾	何時	難字	難事	難治	尓	汝	何次
なんし	男子	南史	難思
なんざ	軟座
なんご	南後	難語	喃語
なんこ	何個
なんけ	南家
なんく	何区
なんぎ	難儀
なんき	何機	南紀
なんが	軟臥
なんか	南下	軟化
なんい	難易	何位	南緯
なんあ	南ア
なをれ	名折れ
なわめ	縄目
なわば	縄張
なわて	畷	縄手
なわた	縄田
なれそ	馴れ初
なれあ	馴れ合
なるみ	成己	鳴海	成美
なるべ	成る可
なると	鳴門	鳴戸
なるち	成知
なるせ	鳴瀬	成瀬
なるご	鳴子
なるこ	鳴子
なるげ	成毛
なるけ	成毛
なるき	成紀
なるお	鳴尾	成雄
なりわ	成羽
なりゆ	成り行	成行
なりや	鳴り止
なりみ	也実	也美
なりふ	形振
なりは	成り果
なりと	成人
なりて	為り手
なりち	成知
なりた	成立	成り立	成田
なりす	成り済
なりさ	成り下
なりこ	成子
なりき	成り切
なりか	成り変	成り代
なりお	成雄
なりあ	成り上
ならべ	並べ
ならび	並び
ならば	→	⊃
ならは	楢葉
ならづ	奈良漬
ならず	不成
ならし	奈良市
ならく	奈落
ならき	奈良木
ならお	奈良尾
ならえ	奈良絵
ならい	奈良井
なよろ	名寄
なよせ	名寄せ
なゆた	那由他	奈由太	那由多
なやみ	悩み
なめら	滑
なめず	舐
なめし	菜飯
なめこ	滑子
なめあ	舐め合	舐め上
なみま	波間
なみの	波野	波乗
なみだ	涙	波立	泪
なみじ	波路
なみき	並木	行木
なみお	波雄
なみえ	浪江
なみう	波打
なみい	並み居
なまり	Lead	訛	鉛	Pb
なまや	生焼
なまめ	艶
なまみ	生身
なまふ	生麩
なまぴ	生ピ
なまに	生煮
なまち	生血
なまず	鯰	癜	鮠
なます	膾	鱠	韲
なまじ	憖
なまこ	海鼠
なまき	生木
なまえ	名前
なほみ	奈保美
なほし	直衣
なほこ	奈穂子	菜穂子
なべの	鍋野
なべて	並べて
なべた	鍋田
なべき	鍋気
なへん	那辺	ナ変	奈辺
なぶら	▽	∇
なふだ	名札
なばり	名張
なばな	菜花
なはり	名張	奈半利
なはし	那覇市
なのり	名乗り
なのこ	菜子
なのか	七日	7日	７日
なぬし	名主
なぬか	七日
なにわ	灘	浪花	難波	浪速
なにや	何屋
なにも	何も
なにせ	何せ
なにご	何語
なにげ	何気
なにか	何科	何彼	何か
ななめ	斜め
ななみ	七生	七海
ななぶ	七部
ななつ	七ツ	七つ
ななそ	七十
ななせ	七瀬
ななし	名無し	名無
ななこ	7個	魚子	奈々子	七個
ななか	七華
ななお	七尾
ななえ	奈々絵	七重	七栄	奈々江
なない	七位
なとり	名取
なでら	斜平
なでつ	撫で付
なであ	撫で上
なづけ	名付け	菜漬
なつよ	夏代
なつめ	夏目	棗	棘
なつむ	夏向
なつみ	夏美	夏実	奈津美	夏巳	菜摘
なつび	夏日
なつば	夏場
なつの	夏野
なつこ	夏子	奈津子	那津子	なつ子
なつげ	夏毛
なつぎ	夏着
なつき	夏木	夏生	夏樹	奈月	無月
なつか	懐	長束	懷
なつお	夏生
なつえ	夏江
なっぱ	菜葉	菜っ葉
なだれ	雪崩
なだち	名立
なだく	灘区
なだか	名高
なだい	灘井	名代	名題
なたね	菜種
なたに	名谷
なぞら	準	准	擬	凖
なぞと	謎解
なぜか	何故か
なずら	准	擬	凖
なずな	薺
なすび	茄子	茄
なすの	那須野
なすか	ナス科
なじみ	馴染
なしと	成し遂	為し遂
なしだ	梨田
なしじ	梨子地
なしえ	為し得
なしう	為し得
なざし	名指し
なさけ	情	情け
なごん	納言
なごり	名残	名残り
なごや	和や	名護屋	那古屋	名古屋	名越
なこそ	勿来
なげや	投矢	投げ矢	投げ遣
なげづ	投げ釣
なげつ	投げ付
なげだ	投げ出
なげす	投げ捨
なげし	長押
なげこ	投げ込
なげき	嘆き	歎き
なげか	投げ掛
なげお	投げ落	投げ下
なげう	擲	抛
なげい	投げ入
なげあ	投げ合	投げ上
なける	泣ける
なぐり	名栗
なぐら	名倉	殴羅
なぐも	南雲
なぐさ	慰
なくら	名倉
なくな	泣く泣
なぎそ	南木曾
なぎさ	渚
なきり	菜切り	奈切
なきや	泣き止	鳴き止
なきふ	泣き伏
なきは	泣き腫
なきぬ	泣き濡
なきつ	泣き付
なきだ	泣き出
なきた	泣き立
なきか	泣き嗄	鳴き交
なきお	泣き落
なきあ	泣き明
ながわ	名川	奈川
ながれ	流れ
ながら	乍	存	長良	乍ら	長柄
ながよ	長与
ながゆ	長湯
ながや	長谷	長家	長屋
ながも	長持
ながめ	長め	長目	眺め
ながみ	永見
ながほ	長保
ながび	長引
ながの	永埜	永野	長野	長能
ながと	長門	長戸
ながて	長手
ながつ	長津	永津
ながた	長田	永田	長多
ながせ	長瀬	永瀬
ながす	長過	長洲
ながさ	長さ
ながき	長岐
ながお	長緒	長夫	長尾	永尾
ながえ	永江	轅	名替	長柄
ながい	長井	長居	長生	永井	永射
なかれ	勿れ	勿	毋	莫れ	毋れ
なから	半ら
なかよ	仲良
なかや	中屋	中谷	仲谷	中矢
なかみ	中味	中身
なかま	仲間	中間	仲魔
なかび	中日
なかば	半ば
なかの	中野	仲野
なかね	中根	中値	仲値
なかぬ	中抜
なかど	中戸
なかで	中出	中手
なかて	中手
なかづ	中吊
なかつ	中津
なかぢ	中地
なかち	仲地	中地
なかだ	仲立	仲田	中田
なかた	仲田	中田
なかそ	中曽
なかせ	中瀬
なかず	中頭	中洲
なかす	中州	中須	中洲
なかじ	中締
なかし	仲仕
なかざ	中座
なかご	中心	中子
なかこ	仲子
なかく	中区
なかき	中木
なかお	中落	中尾
なかえ	中江
なかう	なか卯
なかい	仲居	仲井	中居	中井
なおれ	名折れ
なおや	直弥	名親	直也	尚哉	尚也
なおみ	直実	直美	尚美	奈緒美	奈保美	名保美	奈穂美	なお美
なおと	直人	尚人
なおっ	直
なおた	直田
なおじ	直治
なおし	直史	尚士	直志	尚史	直	直し
なおこ	奈央子	直子	奈保子	菜生子	菜桜子	奈緒子	尚子
なおき	尚紀	直毅	直紀	直喜	直木	直樹
なおえ	尚江	直江
なおい	直井
なえま	苗間
なえぼ	苗穂
なえば	苗場
なえこ	苗子
なえぎ	苗木
なうて	名うて
ないや	内野
ないむ	内務
ないま	綯い交
ないぶ	内部
ないふ	内府
ないひ	内秘	内皮
ないど	内帑
ないち	内地	内治
ないじ	内耳	内示
ないし	内侍	乃至	〜
ないご	内語
ないぎ	内儀
ないき	内記	内規
ないか	内科	内火	内化
ないえ	奈井江
ないい	内意
なあて	名宛
のんべえ	飲兵衛
のろのろ	鈍々
のろくさ	鈍臭
のりろう	憲郎
のりよし	徳吉	法良	紀吉	徳芳
のりゆみ	賭弓
のりゆき	哲之	敬之	矩之	憲行	徳行	規之	紀之	宜之	範行	憲之	徳幸	典行	紀幸	規行	則行	則征	則之	範幸
のりやす	典康
のりもの	乗り物	乗物
のりもと	紀元
のりむね	倫宗
のりまつ	乗松
のりまさ	紀政	典正
のりまき	則巻	海苔巻
のりふみ	憲文
のりひろ	典大	憲広	則浩	紀大
のりひと	徳仁
のりひさ	典尚	則久	哲久	典久	範久
のりひこ	紀彦	規彦	憲彦
のりにげ	乗逃げ
のりづけ	糊付け	糊付
のりづき	法月
のりつづ	乗り続
のりつぎ	乗り継ぎ	乗継
のりちか	乃親
のりたけ	憲武	則竹
のりたか	範高	典孝	則貴
のりすご	乗り過
のりしろ	糊代
のりしげ	則茂
のりざね	徳実
のりこし	乗越	乗り越し
のりくら	乗鞍
のりかた	乗り方
のりかず	則和	紀和
のりかか	乗り掛
のりかえ	乗換	乗換え	乗り換え
のりおり	乗り降り
のりおく	乗り遅
のりいれ	乗り入れ	乗入	乗入れ
のりあわ	乗り合
のりあき	則明	紀昭	紀明	功晶	範明	規昭	憲明	徳晶	典明	典昭	憲章	倫明	法明
のりあい	乗り合い	乗合
のらねこ	野良猫	ノラ猫
のらいぬ	野良犬
のもざき	野母崎
のめりこ	のめり込
のみやま	野見山
のみもの	飲物	飲み物
のみみず	飲み水
のみはじ	飲み始
のみなお	飲み直
のみつづ	飲み続
のみだい	飲み代
のみすぎ	飲み過ぎ
のみしろ	呑み代	飲み代
のみぐん	能美郡
のみぐち	呑口
のみくち	飲み口	飲口
のみくい	呑み喰い	飲み食い	飲み喰い
のみかた	飲み方
のみかい	呑み会	飲み会
のみある	飲み歩
のまおい	野馬追
のぼりと	登戸
のぼりつ	上り詰	登り詰
のぼせあ	逆上せ上
のほうず	野放図
のべやま	野辺山
のべつぼ	延坪
のべがみ	延紙
のべがね	延金
のべおか	延岡
のべいた	延板
のぶろう	宣郎	伸郎	信郎
のぶよし	伸好	信義
のぶゆき	伸幸	伸之	信幸	伸介	信行	宣之	信之	暢之	伸行	展之
のぶやす	延康	宣保	信康
のぶみつ	信光
のぶまさ	伸昌	宣政
のぶふさ	信房
のぶひろ	伸廣	伸啓	展弘	伸裕	宣博	信博	伸浩	信寛	伸広	信宏	信洋	信弘	宣弘	伸弘
のぶひと	宣仁
のぶひで	宣秀
のぶひさ	暢久	信久	延久	順久
のぶひこ	伸彦	宣彦	延彦	暢彦	信彦
のぶはる	伸治
のぶはら	信原
のぶなが	信長
のぶただ	信忠
のぶたか	伸啓	信孝	信隆	信高
のぶせり	野臥せり	野伏せり
のぶすけ	宣介
のぶくに	信邦
のぶかつ	信克	信雄	信勝
のぶかず	信和
のぶおき	暢興
のぶおか	信岡
のぶあき	信昭	信明	伸晃	伸明	悦旦	延晃	宣明
のびりつ	伸び率	伸率
のびのび	伸び伸び
のびなや	伸び悩
のびたき	野鶲
のばなし	野放し
ののやま	野々山
ののむら	野々村
ののはら	野々原
ののぐち	野々口
ののいち	野々市
のねずみ	野鼠
のどもと	喉元
のどぶえ	喉笛
のどごし	喉越し
のどあめ	喉飴	のど飴
のとせん	能登線
のとじま	能登島
のとがわ	能登川
のとかわ	能登川
のつはる	野津原
のっぽろ	野幌
のっぴき	退っ引き
のっとり	乗っ取り
のちょう	野帳
のちほど	後程
のちのち	後々
のちぞえ	後添え
のちぞい	後添い
のちかわ	後川
のだはま	野田浜
のだせん	野田線
のだがわ	野田川
のたれじ	野垂れ死
のぞりこ	野反湖
のぞきみ	覗き見
のぞきこ	覗き込
のそだち	野育ち
のせぐち	能勢口
のせがわ	野迫川
のじりこ	野尻湖
のじゅく	野宿
のじいた	野地板
のしがみ	熨斗紙
のしある	伸し歩
のざわな	野沢菜
のざらし	野晒し
のさっぷ	納沙布
のこりゆ	残り湯
のこりび	残り火
のこりが	残り香
のこらず	残らず
のこした	残した
のこくず	鋸屑
のこぎり	鋸
のけもの	除け者
のぎざか	乃木坂
のぎさか	乃木坂
のきわり	軒割
のきなみ	軒並
のきたけ	軒丈
のきした	軒下
のきさき	軒先
のきげた	軒桁
のきうら	軒裏
のおがた	直方
のうりん	農林
のうりつ	能率
のうらん	悩乱
のうよう	嚢瘍	膿瘍
のうやま	納山
のうやく	農薬
のうめん	能面
のうみん	農民
のうみつ	濃密
のうみそ	脳みそ	脳ミソ	脳味噌
のうまく	脳膜
のうほん	納本
のうほう	農法	膿疱	嚢胞
のうべん	能弁
のうへい	農兵
のうぶん	能文
のうひん	納品
のうひつ	能筆
のうにん	納人
のうなし	能無し
のうない	脳内
のうどち	濃度値
のうどう	能動	農道
のうてん	脳天
のうてい	脳底
のうだい	農大
のうたん	濃淡
のうそん	農村
のうそう	農宗
のうぜい	納税
のうせん	農専	能詮
のうせい	農政	能性
のうずい	脳髄
のうすい	農水
のうじゅ	納受
のうじず	脳磁図
のうしょ	能書	農書
のうしゅ	嚢腫
のうしゃ	納車
のうしつ	脳室
のうざい	能材
のうさん	農産
のうさつ	納札	悩殺
のうさく	農作
のうさぎ	野兎
のうさい	納采
のうこん	濃紺
のうこつ	納骨
のうこう	農耕	農工	濃厚
のうげか	脳外科
のうげい	農芸
のうけん	脳研
のうきん	納金
のうきぐ	農機具
のうがや	能ヶ谷
のうがく	農学	能楽
のうがき	能書	能書き
のうかん	能管	納棺	脳幹	納竿
のうかく	能格
のうかい	納会
のうえん	農園	脳炎	濃艶
のいちご	野苺
のあそび	野遊び
ねんれい	年齢	年令
ねんりん	年輪
ねんりょ	念慮
ねんりつ	年率
ねんりき	念力
ねんらい	年来
ねんゆう	念友
ねんまつ	年末
ねんまく	粘膜
ねんまえ	年前
ねんぽう	年俸	念法	年報
ねんべつ	年別
ねんぶん	年分
ねんぶつ	念仏
ねんぱい	年配	年輩
ねんばん	年版
ねんばら	年払
ねんはん	年半
ねんねん	年年	年々
ねんにん	念人
ねんない	年内
ねんどう	念動
ねんとう	年頭	念頭
ねんてん	捻転
ねんだい	年代
ねんそつ	年卒
ねんせい	年生	粘性	年制
ねんすう	年数
ねんじゅ	念珠
ねんじゃ	念者
ねんしょ	年初	念書
ねんしゃ	念写
ねんした	年下
ねんしき	年式
ねんさん	年産
ねんさい	年歳	年祭
ねんごろ	懇ろ	年頃
ねんごう	年号
ねんこん	念根
ねんこう	年功
ねんげん	年限
ねんげつ	年月
ねんくれ	年暮
ねんきん	年金	粘菌
ねんきり	年切り
ねんがん	念願
ねんがく	年額
ねんかん	年間	年鑑	年刊
ねんかい	年回	年会
ねんえき	粘液
ねんいり	念入	念入り
ねんあけ	年明け	年明
ねんあき	年明き
ねわざし	寝業師
ねりもの	練り物	練物	煉り物
ねりまく	練馬区
ねりべい	練塀
ねりぬき	練貫
ねりなお	練り直
ねりこう	練香	煉香
ねりきり	煉り切り
ねりがし	練菓子	練り菓子
ねりかた	煉り固	練り固
ねりいろ	練色
ねりある	練り歩
ねらいめ	狙い目
ねらいす	狙い澄
ねらいう	狙い撃
ねやがわ	寝屋川
ねめまわ	睨め回
ねむりこ	眠り込
ねむのき	合歓木	棔
ねみだれ	寝乱れ
ねまわり	根回り
ねまわし	根回し
ねぼすけ	寝坊助
ねぶそく	寝不足
ねぶくろ	寝袋
ねぶかわ	根府川
ねびらき	値開き
ねびきか	値引可
ねばりぬ	粘り抜
ねばりつ	粘り着
ねばりけ	粘り気
ねばつち	粘土
ねはんず	涅槃図
ねはんえ	涅槃会
ねとまり	寝泊まり	寝泊り
ねづえき	根津駅
ねつろん	熱論
ねつれつ	熱烈
ねつるい	熱涙
ねつりき	熱力
ねつらい	熱雷
ねつよく	熱浴
ねつぼう	熱望
ねつべん	熱弁
ねつふか	熱負荷
ねつてき	熱的
ねつぞう	捏造
ねつげん	熱源
ねつけん	熱研
ねつぐん	熱群
ねつきぐ	熱器具
ねつがん	熱願
ねつかん	熱感
ねつかく	熱核
ねつえん	熱演
ねつあい	熱愛
ねっぷう	熱風
ねっぱつ	熱発
ねっとう	熱闘	熱湯	熱鬧
ねってい	熱低
ねったい	熱帯
ねっせん	熱線	熱戦
ねっせい	熱性
ねっすい	熱水
ねっしん	熱心
ねっしょ	熱暑
ねっしゅ	熱酒
ねっしゃ	熱写
ねっさん	熱讃
ねっけん	熱圏
ねっけつ	熱血
ねっから	根っから
ねちがえ	寝違え
ねだんさ	値段差
ねだやし	根絶やし
ねたんぽ	根担保
ねたばこ	寝煙草
ねずみと	鼠取
ねすがた	寝姿
ねじしき	ねじ式
ねじこみ	捩じ込み
ねざかな	根魚
ねさがり	値下がり
ねごこち	寝心地
ねこみみ	猫耳
ねこまた	猫又
ねこばば	猫糞
ねこのめ	猫の目
ねこそぎ	根刮ぎ
ねこじた	猫舌
ねこがた	猫型
ねこかん	猫缶
ねこいた	猫板
ねこあし	猫脚	猫足
ねくずれ	値崩れ
ねぎあか	ネギ亜科
ねがえり	寝返り
ねがいで	願い出
ねがいさ	願い下
ねかしつ	寝かし付
ねおじむ	Nd	Neodymium
ねえさん	姉さん
ねえさま	姉様
ねうごき	値動き
ねいひつ	寧謐
ねいじつ	寧日
ねいしん	佞臣
ねいかん	佞奸
ねあらい	値洗い
ねあがり	値上がり	根上	根上り
ぬれごと	濡れ事	濡事
ぬれぎぬ	濡れ衣	濡衣
ぬれがみ	濡れ髪
ぬるまゆ	微温湯	ぬるま湯
ぬりもの	塗物
ぬりばし	塗り箸	塗箸
ぬりなお	塗り直
ぬりつぶ	塗り潰
ぬりつけ	塗付
ぬりかべ	塗り壁	塗壁
ぬりかた	塗り固
ぬまやま	沼山
ぬまづし	沼津市
ぬまずし	沼津市
ぬまじり	沼尻
ぬまざき	沼崎
ぬまぐち	沼口
ぬまくら	沼倉
ぬまくま	沼隈
ぬまがみ	沼上
ぬまかわ	沼川
ぬまかみ	沼上
ぬまかぜ	沼風
ぬまおか	沼岡
ぬまうえ	沼上
ぬのむら	布村
ぬのまき	布巻
ぬのびき	布引
ぬのはし	布橋
ぬのせい	布製
ぬのきれ	布切れ
ぬのかわ	布川
ぬのいち	布市
ぬすみみ	盗み見
ぬすみと	盗み取
ぬすみだ	盗み出
ぬすみぐ	盗み食
ぬすみぎ	盗み聞
ぬすびと	盗人
ぬすっと	盗人
ぬけみち	抜道	抜け道
ぬけにん	抜忍
ぬけさく	抜け作
ぬけぐち	抜け口
ぬけがら	抜け殻	蛻	脱け殻	抜殻	脱殻
ぬけがけ	抜駆	抜け駆け
ぬけあな	抜穴	抜け穴
ぬぐいさ	拭い去
ぬくしな	温品
ぬぎすて	脱ぎ捨て
ぬきんで	抜きん出
ぬきよみ	抜読み
ぬきやま	抜山
ぬきほん	抜本
ぬきとお	貫き通
ぬきだし	抜き出し
ぬきずり	抜刷
ぬきさし	抜き差し
ぬきがき	抜き書き
ぬきうち	抜打ち	抜き打ち
ぬきいと	緯糸
ぬかるみ	泥濘
ぬかみそ	糠味噌
ぬかびら	糠平
ぬかばえ	糠蠅
ぬかどこ	糠床
ぬかづけ	糠漬
ぬいもの	縫物
ぬいばり	縫い針	縫針
ぬいしろ	縫代
ぬいいと	縫い糸	縫糸
ぬいあわ	縫い合
にんよう	任用	認容
にんめん	任免
にんめい	任命	任名
にんまえ	人前
にんぽう	忍法
にんべん	人偏
にんべつ	人別
にんぶん	人分
にんぴん	人品
にんねん	人年
にんにち	人日
にんにく	蒜	葫	大蒜
にんなじ	仁和寺
にんどう	忍道
にんとく	仁徳
にんでん	人天
にんてん	人天
にんてい	人体	認定
にんちど	認知度
にんだく	認諾
にんたい	忍耐
にんそく	人足
にんそう	人相
にんずう	人数
にんじん	人参	人蔘	忍人
にんじゃ	忍者
にんしん	妊娠
にんしき	認識
にんげん	人間
にんげつ	人月
にんぐみ	人組
にんぎょ	人魚
にんきょ	認許
にんがい	人界	人外
にんかん	任官
にんいこ	任意個
にわとり	鶏	鷄
にわたし	荷渡
にわさき	庭先
にわさか	庭坂
にわいし	庭石
にれつめ	二列目
にるいだ	二塁打
にりんか	二輪花
にりゅう	二流
にらやま	韮山
にらみつ	睨み付
にらみあ	睨み合
にらづか	韮塚
にらさわ	韮沢
にらさき	韮崎
にょらい	如来
にょぼん	女犯
にょほう	如法
にょにん	女人
にょたい	女体
にょじつ	如実
にょかん	女官
にょうろ	尿路
にょうそ	尿素
にょうご	女御
にょうい	尿意
にょいん	女院
にょいち	如一
にゅうわ	柔和
にゅうぶ	入部
にゅうふ	入夫
にゅうひ	入費
にゅうの	入野
にゅうじ	乳児
にゅうし	乳歯	乳脂	入試
にゅうこ	入呼	入庫
にゅうか	乳化	入荷	入科
にもじめ	二文字目
にみょう	二名
にまいめ	二枚目
にまいげ	二枚蹴
にほんめ	二本目
にほんま	日本間
にほんば	日本馬
にほんし	日本史
にほんざ	二本差
にほんご	日本語
にほんが	日本画
にほんか	二本化
にぶんぎ	2分木	二分木
にぶんき	二分木
にぶんか	二分化
にぶさく	二部作
にびたし	煮浸し
にびいろ	鈍色
にひゃく	二百
にひきめ	二匹目
にばんめ	2番目	二番目
にばんて	二番手
にばしゃ	荷馬車
にばいす	二杯酢
にはつめ	二発目
にはくめ	二拍目
にはいず	二杯酢
にのみや	二の宮	二宮
にのまる	二の丸
にのまい	二の舞い	二の舞
にのつぎ	二の次
にのうで	二の腕
にのあし	二の足
にねんめ	二年目
にねんご	二年後
にながわ	蜷川
にないて	担い手
にどぬり	二度塗
にどでま	二度手間
にどざき	二度咲き
にどうち	二度打ち
にとうめ	二頭目
にづくり	荷作り	荷造り
につうめ	2通目
にっぽん	日本
にっぽり	日暮里
にっぽう	日豊	日報
にっぱち	二八
にっとう	日塔	日東	入唐	日当
にってん	日展
にってれ	日テレ
にってつ	日鉄
にってい	日帝	日程
にっつう	日通
にっちも	二進も
にっちつ	日窒
にったん	日鍛
にったく	日拓
にっせき	日赤	日夕	日石
にっせい	日精	日生
にっすう	日数
にっしん	日心	日新	日進	日神	日清
にっしゃ	日射
にっさん	日産	日参
にっこり	莞爾
にっこう	日興	日光	日工	日航
にっける	Ni	Nickel
にっけい	日系	日計	日経	肉桂
にっくに	新国
にっくう	日空
にっきん	日勤
にっかん	日刊	日韓
にっかわ	新川
にっかつ	日活
にちろく	日録
にちれん	日蓮
にちれき	日瀝
にちりん	日林	日輪
にちよう	日用	日曜
にちょく	二直
にちょう	二鳥
にちゅう	二中
にちまえ	日前
にちぼつ	日没
にちべい	日米
にちぶん	日文	日分
にちふつ	日仏
にちはん	日半	日販
にちはら	日原
にちはむ	日本ハム
にちにち	日々
にちなん	日南
にちどく	日独
にちどう	日動
にちでん	日電
にちづけ	日付
にちだい	日大	日本大学
にちずい	日瑞
にちじび	日耳鼻
にちげん	日限
にちげつ	日月
にちぎん	日銀
にちがく	日額
にちかん	日間
にちおん	日音
にちおう	日欧
にちえい	日栄	日英	日影
にちいん	日陰
にちいき	日域
にだんめ	二段目
にだいめ	二代目	二台目
にたろう	二太郎
にたやま	仁田山
にたもの	似た者
にたどり	似鳥
にせもの	偽者	贋物	偽物
にせさつ	偽札
にせがね	贋金
にすがた	似姿	荷姿
にじるし	荷印
にじりよ	躙り寄
にじりで	躙り出
にじょう	二条	二乗	二丈	2乗
にじゅう	二重	二十	2重	廿
にじみで	滲み出
にじみだ	滲み出
にじます	虹鱒
にじへき	二次壁
にじばん	二次版
にじてき	二次的	2次的
にじせい	二字姓
にじじこ	二次事故
にじしぶ	二次篩部
にじしき	二次式
にじげん	二次元	２次元	2次元
にじけい	2次系
にじがわ	二次側
にじかん	2時間	二時間
にじかい	二次会
にじいろ	虹色
にしんわ	2進和
にしんぎ	二進木
にしんき	二進木
にしわだ	西和田
にしわき	西脇
にしょく	二色	二食
にしょう	二章
にしゅつ	二出
にしやま	西山
にしもり	西森
にしもと	西本
にしめら	西米良
にしめや	西目屋
にしむろ	西牟婁
にしむら	西村
にしむき	西向き
にしみや	西宮
にしまど	西窓
にしまつ	西松
にしまち	西町
にしまき	西牧
にしふな	西船
にしふじ	西富士
にしひら	西平
にしばん	西版
にしはる	西春
にしはら	西原
にしはま	西浜
にしはた	西畑
にしはし	西橋
にしなり	西成
にしなだ	西灘
にしなす	西那須
にしなが	西永
にしどみ	西富
にしとさ	西土佐
にしとう	西棟
にしてつ	西鉄
にしちく	西地区
にしだて	西館
にしだけ	西岳
にしたま	西多摩
にしたに	西谷
にしたが	西多賀
にしぞの	西園
にしぜき	西関
にしすぎ	西杉
にしじん	西新	西陣
にしじま	西嶋	西島
にししん	西新
にししば	西柴
にしした	西下
にしざわ	西澤	西沢
にしざき	西崎
にしごう	西郷
にしこく	西国
にしこう	西高
にしぐち	西口
にしきみ	錦見
にしきね	和稲
にしきど	錦戸
にしきた	西北
にしきえ	錦絵
にしがわ	西側
にしがや	西ヶ谷
にしがき	西垣
にしかん	西館
にしかわ	西川
にしかも	西加茂
にしかど	西門	西角
にしかた	西片	西形	西方
にしかぜ	西風
にしおぎ	西荻
にしおか	西岡
にしうわ	西宇和
にしうら	西浦	西裏
にしうみ	西海
にしいる	西入ル
にしいず	西伊豆
にしいけ	西池
にしいえ	西家
にしあち	西阿知
にしあい	二試合
にざかな	煮魚
にさんか	二酸化
にごりえ	濁江
にごうめ	二合目
にこごり	煮凝
にげみち	逃げ道
にげみず	逃げ水
にげまわ	逃げ回
にげまど	逃げ惑
にげごし	逃げ腰
にげきり	逃げ切り
にげかく	逃げ隠
にげかえ	逃げ帰
にげおく	逃げ遅
にげおお	逃げ果
にげあし	逃げ足
にぐるま	荷車
にくるい	肉類
にくよく	肉欲
にくよう	肉用
にくみあ	憎み合
にくまん	肉饅
にくぼそ	肉細
にくぼう	肉棒
にくへん	肉片
にくぶと	肉太
にくふん	肉粉
にくひつ	肉筆
にくばな	肉離
にくはく	肉迫	肉薄
にくにく	憎々
にくてい	憎体
にくづめ	肉詰め
にくづけ	肉付け
にくづき	肉付き
にくだん	肉弾	肉彈
にくだま	肉玉
にくだい	肉代
にくたい	肉体
にくせい	肉声
にくずれ	煮崩れ	荷崩れ
にくすい	肉穂	肉垂
にくじる	肉汁
にくじき	肉食
にくしん	肉親	肉身
にくしゅ	肉腫
にくしみ	憎しみ
にくしつ	肉質
にくこう	肉交
にくけい	肉桂
にくきり	肉切り
にくがん	肉眼
にくかん	肉感
にくかい	肉塊
にくおど	肉踊
にくいろ	肉色
にくあつ	肉厚
にぎわい	賑
にぎりし	握り締
にぎょう	2行	二行
にぎやか	賑やか
にぎにぎ	賑々
にぎてき	二義的
にきょく	二曲	二極
にきゅう	二級
にきしゅ	二機種
にきさく	二期作
にきかい	二期会
にがわら	苦笑
にがわせ	荷為替
にがりき	苦り切
にがむし	苦虫
にがにが	苦々
にがつち	苦土
にがっき	二学期
にがたけ	苦竹
にがおえ	似顔絵
にがうり	苦瓜
にかわせ	荷為替
にかよう	似通う
にかしょ	2箇所	二カ所	二箇所
にかこく	二ヵ国
にかげつ	二ヶ月	二カ月	二箇月
にかいめ	二回目	２回目
におろし	荷下ろし	荷卸し
におやか	匂やか
におうだ	仁王立
にえたぎ	煮え滾
にうごき	荷動き
にいむら	新村
にいぼん	新盆
にいばる	新治
にいはる	新治
にいはり	新治
にいはら	新原
にいはま	新居浜
にいぬま	新沼
にいづま	新妻
にいつる	新鶴
にいつま	新妻
にいじま	新島
にいざと	新里
にいざき	新居崎
にいざか	新坂
にいさん	兄さん
にいさま	兄様
にいさと	新里
にいくら	新倉
にいがた	新潟
にいがき	新垣
にいかわ	新川
なんわり	何割
なんれつ	何列
なんりん	何輪
なんらか	何らか
なんよう	南洋	何曜	南陽
なんやく	難役
なんもん	何問	難問
なんもじ	何文字
なんもく	南牧
なんもう	軟毛
なんめん	南面	何面
なんめい	何名
なんみん	難民
なんまん	何万
なんまい	何枚
なんぽん	何本
なんぽろ	南幌
なんぽく	南北
なんぽう	南方
なんぼん	何本
なんぼく	南北
なんぺん	何編
なんぺい	南平
なんべん	軟便	何遍
なんべい	南米
なんぷん	何分
なんぷう	南風	軟風
なんぶん	難文	何分
なんぶつ	難物
なんふん	何分
なんふつ	南仏
なんぴん	難平	何品
なんぴと	何人
なんびと	何人
なんびき	何匹
なんひき	何匹
なんぱつ	何発
なんぱこ	何箱
なんぱく	何拍	何泊
なんばん	軟盤	南蛮	何番
なんばら	南原
なんばい	何杯	何倍
なんはこ	何箱
なんはく	何拍
なんのう	南濃
なんねん	何年	難燃
なんねい	南寧
なんにん	何人
なんにょ	男女
なんにち	何日
なんなく	難無く	難なく
なんどめ	何度目
なんどく	難読
なんどき	何時
なんどう	南洞
なんとか	何とか
なんとお	何通
なんとう	南東	何頭	何等	軟投	南島
なんでも	何でも
なんでい	軟泥
なんてん	何店	難点	何点	南天
なんてつ	軟鉄
なんてき	難敵	何滴
なんてい	軟庭
なんつう	何通
なんちん	南京	Nanjing
なんだん	何段	南淡
なんだか	何だか
なんだい	何台	難題	何代
なんたん	南端
なんたる	何たる
なんたい	軟体	男体	何体
なんそく	何足
なんそう	何走	南総	南宋	何層
なんぜん	何千
なんせん	南線	難船
なんせき	何隻
なんせい	何世	南西	軟性	南勢
なんすい	軟水
なんじら	汝等
なんしん	南進
なんしょ	難所
なんしゅ	何種
なんしつ	軟質
なんしき	軟式
なんざん	南山	難産
なんさつ	何冊
なんさく	何作
なんさい	何才	何歳
なんごく	南国
なんごう	何号	南郷
なんこつ	軟骨
なんこく	南国
なんこう	南港	南高	軟膏	軟攻	楠公	難航	軟鋼	南郊	南光
なんげん	何軒	南限
なんけん	軟件	何軒	難件	何件
なんけた	何桁
なんぐん	南軍
なんぐう	南宮
なんくん	難訓
なんくみ	何組
なんくち	何口
なんくせ	何癖	難癖
なんきん	南京	軟禁	Nanjing
なんきつ	難詰
なんがん	南岸
なんがつ	何月
なんがい	南外
なんかん	難関	南関	何巻
なんかい	何回	難解	南海	何階
なんおん	軟音
なんおく	何億
なんおう	南欧
なんえん	何円
なんいど	難易度
なんあり	難有り
なわばり	縄張り	縄張
なわない	縄綯い
なわとび	縄跳び
なわじり	縄尻
なわしろ	苗代
なわおか	縄岡
なれなれ	馴々
なれそめ	馴れ初め
なれずし	熟鮨
なれした	慣れ親
なれあい	馴れ合い
なるよし	成良
なるみつ	成光
なるほど	成程	成る程
なるべく	成る可く	可成
なるひろ	成広
なるひさ	徳寿
なるひこ	徳彦
なるとう	成東
なるたき	鳴滝
なるしま	成島	成嶋
なるさわ	成澤	成沢	鳴沢	鳴澤
なるきよ	成清
なるかみ	鳴神
なるあき	成章
なりわた	鳴り渡
なりわい	生業	業
なりよし	成良
なりゆき	成行き	成行	成り行き
なりやす	成康
なりもの	鳴物
なりもと	成本
なりみつ	成允
なりまつ	成松
なります	成増
なりふり	形振り
なりひろ	成洋
なりひら	業平
なりひび	鳴り響
なりひと	成人
なりはら	成原
なりとも	成伴	成知
なりとみ	成富
なりたや	成田屋
なりたつ	成り立つ
なりたち	成立ち
なりたし	成田市
なりしま	成嶋
なりしげ	成茂
なりさわ	成澤	成沢
なりさと	成里
なりこま	成駒
なりぎん	成銀
なりきん	成金
なりかわ	成川	成り代
なりあき	成昭
なりあい	成合
ならわし	習わし
ならやま	平城山
ならべた	並べ立
ならべか	並べ替	並べ変	並べ換
ならびに	並びに
ならびた	並び立
ならびか	並び換
ならはら	奈良原
ならでん	奈良電
ならづけ	奈良漬
ならちく	奈良地区
ならせん	奈良線
ならしの	習志野
ならざき	楢崎
ならさき	楢崎
ならけん	奈良県
ならかん	奈良間
ならかわ	楢川
ならおか	奈良岡
ならえき	奈良駅
なよたけ	弱竹
なめらか	滑らか
なめまわ	舐め回
なめつく	舐め尽	嘗め尽
なめくじ	蛞蝓
なめがた	行方
なめかわ	滑川
なめかた	行方
なめいし	大理石
なむさん	南無三
なみよけ	波除け
なみまつ	並松
なみまく	波幕
なみへい	波平
なみはば	並幅
なみはず	並外	並み外
なみのり	波乗り	波乗
なみなみ	並々
なみとう	並等
なみだめ	涙目
なみせん	波線
なみせい	並製
なみこし	浪越
なみきざ	並木座
なみがた	波形
なみがけ	並罫
なみがい	浪貝
なみかわ	並河	浪川
なみかた	波方
なみかぜ	波風
なみおと	波音
なみおか	浪岡
なみうち	波打
なみいる	並み居る
なみいか	並以下
なみあし	並足
なみあい	浪合
なまろく	生録
なまよい	生酔い
なまやさ	生易
なまやけ	生焼け
なまもの	生物
なまめん	生麺
なまむぎ	生麦
なまみそ	生味噌
なまみず	生水
なままめ	生豆
なまぼし	生乾し
なまばな	生花
なまはだ	生肌
なまはげ	生剥げ
なまぬる	生温
なまにく	生肉
なまにえ	生煮え
なまなま	生々	生生
なまづめ	生爪	生詰
なまつば	生唾
なまだら	生ダラ
なまため	生田目	生天目
なまじろ	生白
なまごろ	生殺
なまごめ	生米
なまごみ	生ゴミ	生塵
なまぐさ	腥	生臭
なまくら	鈍
なまくび	生首
なまがわ	生皮	生乾
なまがし	生菓子
なまがき	生牡蛎	生蛎
なまかわ	生皮
なまかべ	生壁
なまおん	生音
なまおと	生音
なまえま	名前負
なまえつ	名前付
なまいき	生意気
なまあん	生餡
なまあし	生脚	生足
なまあげ	生揚げ
なほざり	等閑
なべやき	鍋焼き	鍋焼
なべもの	鍋もの	鍋物
なべぶた	鍋蓋
なべはり	鍋貼
なべたに	鍋谷
なべぞこ	鍋底
なべしま	鍋島
なべかま	鍋釜
なべかい	鍋会
なはさば	鯆
なはえき	那覇駅
なのりで	名乗り出
なのはな	菜の花
なのかめ	七日目
なによう	何用
なにゆえ	何故
なにやつ	何奴
なにもの	何者	何物
なにほど	何程
なにぶん	何分
なにびと	何人
なにひと	何一
なになに	何々	何何
なにとぞ	何卒
なにせん	何線
なにじん	何人
なにしろ	何しろ
なにさま	何様
なにごと	何事	何言
なにげな	何気無
なにけん	何県
なにけい	何系
なにがた	何型
なにがし	何某	某
なにかと	何彼と
なにいろ	何色
ななやま	七山
ななまが	七曲
ななふし	竹節虫
ななひき	七匹
ななねん	七年
ななにん	七人
ななつか	七塚
ななだる	七滝
ななたま	七玉
ななたび	七度
ななそじ	七十路
ななさん	七三
ななさわ	奈々沢
ななくま	七隈
ななくさ	七草
ななきた	七北田
ななかく	七角
ななかい	七会
なないろ	七色
などなど	等々
などころ	名所
なとりし	名取市
なでまわ	撫で回
なではら	撫原
なでしこ	撫子
なでさす	撫で擦
なでぎり	撫で斬り
なでがた	撫で肩
なつよう	夏用
なつやま	夏山
なつやせ	夏痩せ
なつやす	夏休
なつもの	夏物
なつめろ	懐メロ
なつむし	夏虫
なつむき	夏向き
なつまつ	夏祭
なつまけ	夏負	夏負け
なつふく	夏服
なつひこ	夏彦
なつばん	夏版
なつばて	夏バテ	夏ばて
なつどり	夏鳥
なつぞら	夏空
なつぜみ	夏蝉
なつさく	夏作
なつごろ	夏頃
なつごう	夏号
なつこみ	夏コミ
なつぐも	夏雲
なつくさ	夏草
なつがれ	夏枯れ
なつがた	夏型
なつがき	夏牡蛎
なつかわ	夏川
なつかぜ	夏風邪
なつかし	懐かし
なついん	捺印
なついろ	夏色
なつあき	夏秋
なっとく	納得
なっとう	納豆
なっせん	捺染
なっしょ	納所
なだれこ	雪崩れ込	傾れ込
なだたる	名立たる
なださき	灘崎
なだこう	灘校	灘高
なたまめ	鉈豆
なぞわざ	謎技
なぞなぞ	謎々
なぞとき	謎解き
なぞがく	謎学
なぜなら	何故なら	∵
なすりつ	擦り付
なすもく	ナス目	Solanales
なすすべ	為す術
なすこん	茄子紺
なしだい	梨大
なしくず	済し崩
なさけな	情無	情け無
なさけし	情け知
なごりお	名残惜
なごやし	名古屋市
なごやか	和やか
なこうど	仲人
なこうじ	若王寺
なげわた	投げ渡
なげわざ	投げ技
なげやり	投槍	投げ槍	投げ遣り
なげぶみ	投文	投げ文
なげなわ	投げ縄
なげづり	投げ釣り	投げ釣
なげざお	投げ竿
なげくび	投げ首
なげかえ	投げ返
なげうり	投げ売り	投売り
なげあみ	投げ網	投網
なぐりつ	殴り付
なぐりこ	殴り込
なぐりあ	殴り合
なぐさめ	慰め
なくなく	泣く泣く
なぎょう	ナ行	な行
なぎはら	薙ぎ払
なぎなた	長刀	薙刀
なぎたお	薙ぎ倒
なきわめ	泣き喚
なきわか	泣き別
なきもの	亡き者
なきむし	泣き虫
なきまね	鳴き真似	泣き真似
なきべそ	泣きべそ
なきはら	泣き腫
なきねい	泣き寝入
なきつら	泣き面
なきつづ	泣き続
なきつか	泣き疲
なきそぼ	泣き濡
なきしず	泣き沈
なきしき	鳴き頻	泣き頻
なきさけ	泣き叫
なきごと	泣き言
なきごえ	鳴声	泣き声	鳴き声
なきくら	泣き暮
なきくず	泣き崩
なきがら	亡骸
なきがお	泣き顔
なきおと	泣き落
ながれゆ	流れ行
ながれや	流れ矢
ながれで	流れ出
ながれだ	流れ出
ながれず	流れ図
ながれこ	流れ込
ながらく	長らく
ながよし	永吉	長吉
ながゆき	長幸
ながやり	長槍
ながやみ	長病み
ながやま	永山	長山
ながやす	永安
ながもり	長森	永森
ながもち	長もち	長持ち	長持
ながめや	眺め遣
ながむね	長宗
ながむし	長虫
ながみね	長峯	長嶺
ながみつ	長光	永光
ながみち	長道
ながまつ	永松	長松
ながまち	長町
ながまさ	長政
ながぶろ	長風呂
ながぶち	長渕	長淵
ながぶせ	長伏
ながふさ	長房
ながびつ	長櫃
ながひと	長人
ながはる	長治
ながはら	長原	永原
ながはま	長濱	長浜
ながはた	永幡
ながはし	長橋
ながのし	長野市
ながねん	長年	永年
ながねぎ	長ネギ	長葱
ながぬま	長沼
ながなが	長々
ながとろ	長瀞
ながとも	永友	長友
ながとみ	長冨	長富
ながとの	長殿
ながとし	長年
ながつま	長妻
ながつづ	長続
ながつだ	長津田
ながつき	長月
ながつか	長束	長塚
ながたび	長旅
ながたに	長谷	永谷
ながそで	長袖
ながすぎ	長過	長過ぎ
ながしめ	流し目
ながしま	永嶋	長嶋	永島	長島
ながしば	流し場
ながしの	長篠
ながしさ	流し去
ながしこ	流し込
ながさわ	永沢	長澤	長沢
ながさく	永作
ながさき	長崎	永崎
ながさか	長坂
ながごと	長言
ながぐつ	長靴
ながくら	長倉
ながくぼ	長久保
ながくて	長久手
ながぎぬ	長衣
ながぎし	永岸
ながおか	永岡	長岡
ながおい	長追い
ながうた	長唄	長歌
ながいも	長薯	長芋
ながいた	長板
ながいす	長椅子
ながいし	長石
ながいけ	長池
ながいき	長生き	長生
ながあめ	長雨
なかわり	中割り
なかわた	中綿
なかよし	仲良し
なかよく	仲良く
なかゆび	中指
なかやま	仲山	中山
なかもん	中門
なかもり	中森
なかもと	中元	仲本	中本
なかもず	中百舌鳥
なかむら	仲村	中村
なかみち	仲道	中道
なかみぞ	中溝
なかみせ	仲見世
なかまわ	仲間割
なかまる	中束	・
なかまつ	中松
なかまち	中町	仲町
なかまく	中幕
なかまき	中牧
なかまい	仲間入
なかぼね	中骨
なかほり	中堀
なかほど	中程
なかへじ	中辺路
なかぶと	中太
なかひら	中平
なかばん	中番
なかばる	中原
なかはら	中原
なかはま	中浜
なかはた	中畑
なかはし	中橋
なかのべ	中延
なかのし	中野市
なかのく	中野区
なかぬり	中塗り
なかにわ	中庭
なかにも	中にも
なかにし	中西
なかなか	仲々	難々	中々	中中
なかなお	仲直
なかとみ	中富
なかとじ	中綴じ
なかとさ	中土佐
なかとき	中時
なかとう	中藤
なかてん	・	中点
なかづり	中吊り
なかつぎ	中継ぎ
なかつか	中塚
なかつえ	中津江	中枝
なかちく	中地区
なかだる	中弛
なかだて	中舘
なかだち	中立	媒	仲立ち	仲立
なかだし	中出し
なかだか	中高
なかたね	中種子
なかたに	中谷	仲谷
なかたど	仲多度
なかたが	仲違
なかぞら	中空
なかぞの	中薗	中園
なかそね	中曽根	仲宗根
なかせん	中仙
なかずみ	中澄
なかすみ	中済
なかすじ	中筋
なかすぎ	中杉
なかじめ	中締め
なかじま	中陦	中島	中嶋	仲島
なかしま	中島	中嶋
なかした	中下
なかざわ	中澤	仲沢	中沢
なかざと	中里	仲里
なかざき	中崎	仲崎
なかさと	中里
なかさく	中作
なかさき	中崎
なかごろ	中頃	中ごろ
なかごめ	中込
なかごみ	中込
なかごし	中越
なかごう	中郷
なかこま	中巨摩
なかぐろ	・	中黒
なかぐち	中口
なかくろ	・
なかくら	中倉	仲倉
なかくぎ	中釘
なかぎり	中桐	中限
なかぎし	中岸
なかきた	中来田	中北
なかがわ	那賀川	中川	仲川	那珂川
なかがみ	中上
なかがた	中潟
なかがき	中垣
なかがい	仲買
なかおれ	中折れ
なかおち	中落ち
なかおく	中奥
なかおか	中岡
なかうみ	中海
なかうま	中馬
なかうち	中内
なかいわ	中岩
なかいり	中入	中入り
なかいま	仲井真
なかいち	中市
なかいた	中板
なかいず	中伊豆
なかいけ	仲池
なかあし	中足
なおよし	直義	直良
なおゆき	尚幸	尚之	直之	直幸	直行
なおみち	直道
なおまさ	直昌
なおふみ	直史	尚文
なおひろ	直廣	直弘	直広	直大	尚弘	尚宏	直宏
なおひと	直人	直仁
なおひで	直秀
なおひさ	直久	尚久
なおひこ	尚彦	直彦
なおはる	直治
なおはら	猶原
なおのり	直徳	尚紀	尚憲
なおのぶ	直宣
なおとし	直敏	直利	尚稔
なおたけ	尚武
なおたか	直孝
なおずみ	尚純	直純
なおしま	直島
なおざり	等閑
なおさら	尚更
なおきち	直吉
なおがき	尚書き
なおかわ	直川
なおかつ	猶且	直勝
なおかず	直一	直和
なおえつ	直江津
なおいり	直入
なおいち	直一
なおあき	尚明	直明
なえむら	苗村
なえなえ	萎え萎え
なえどこ	苗床
なえしろ	苗代
なえいろ	苗色
ないりん	内輪
ないりく	内陸
ないらん	内乱	内覧
ないよう	内容	内用
ないゆう	内憂
ないやく	内約
ないもう	内毛
ないめん	内面
ないめい	内命
ないみつ	内密
ないまぜ	綯い交ぜ
ないまく	内幕
ないほう	内法	内方	内報	内包
ないへき	内壁
ないぶん	内分	内聞
ないぶは	内部波
ないふん	内紛
ないふく	内服
ないねん	内捻	内燃
ないない	内々
ないどう	内道
ないとう	内藤
ないてん	内典	内転	内点
ないてき	内的
ないてい	内定	内庭	内偵
ないつう	内通
ないだん	内談
ないだく	内諾
ないだい	内題
ないたつ	内達
ないたい	内体	内帯
ないぞく	内属
ないぞう	内蔵	内臓
ないそく	内側	内足	内則
ないそう	内奏	内装	内挿	内争	内層
ないぜん	内膳
ないせん	内線	内戦
ないせつ	内接
ないせき	内積	内戚
ないせい	内政	内製	内生	内省	内声
ないすん	内寸
ないじん	内陣
ないじょ	内助
ないじゅ	内需
ないじつ	内実
ないしん	内診	内申	内心
ないしょ	内緒
ないしつ	内室
ないしき	内式
ないざい	内在
ないさい	内済	内妻
ないこん	内婚
ないこく	内国
ないこう	内訌	内攻	内向
ないけん	内見
ないけい	内径
ないぐう	内宮
ないくん	内訓
ないくう	内腔	内宮
ないきん	内勤
ないがし	蔑
ないがい	内外
ないかん	内官	内観	内患
ないかひ	内果皮
ないかく	内角	内閣	内郭
ないかい	内界	内回	内海	内科医
ないおう	内奥	内応
ないえん	内縁	内苑
ないえつ	内閲	内謁
ないいん	内因	内院
ないあつ	内圧
のんだくれ	飲んだくれ
のれんわけ	暖簾分け
のるうぇー	諾威
のりのみや	紀宮
のりそこな	乗り損
のりごこち	乗り心地	乗心地
のらしごと	野良仕事
のみりょう	飲み料
のみのいち	蚤の市
のみなかま	飲み仲間
のみこうい	呑行為	呑み行為
のみぐすり	飲薬	飲み薬
のぼりべつ	登別
のぼりせん	上り線
のぼりざか	上り坂	登り坂
のぼりぐち	上り口	登り口
のぼりくち	上り口	登り口
のべばらい	延べ払い
のべおくり	野辺送り
のびちぢみ	伸び縮み
のびざかり	伸び盛り
ののしりあ	罵り合
のどぼとけ	喉仏
のどじまん	喉自慢
のとちほう	能登地方
のてんぶろ	野天風呂
のたれじに	野垂れ死に
のぞきまど	覗き窓
のぞきあな	覗き穴
のしろこう	能代工
のしろえき	能代駅
のしぶくろ	熨斗袋
のざききた	野崎北
のこりもの	残り物
のこりかす	残り滓
のこのしま	能古島
のぐちけん	野口研
のきならび	軒並び
のおがたし	直方市
のうりょく	能力	濃緑
のうりょう	脳梁	納涼
のうみんで	農民出
のうみんが	農民画
のうぶたい	能舞台
のうふしょ	納付書
のうふしゃ	納付者
のうびょう	脳病
のうひんじ	納品時
のうひょう	脳表
のうはんき	農繁期
のうにゅう	納入
のうどてき	濃度的
のうてんき	脳天気	能天気	腦天氣
のうちゅう	脳中	嚢虫	嚢中
のうちほう	農地法
のうたんち	濃淡値
のうたりん	脳足りん
のうそんぶ	農村部
のうじれき	農事歴
のうじょう	嚢状	農場
のうじゅう	膿汁
のうしょう	農相	脳漿	脳症
のうしゅく	濃縮
のうしゅう	濃州
のうしゃび	納車日
のうしゃじ	納車時
のうしゃご	納車後
のうさんち	農産地
のうぎょう	農業
のうきょう	膿胸	農協	納経
のうきのう	脳機能
のうがくぶ	農学部
のうがくし	能楽師
のうかんき	農閑期
のうかしん	膿痂疹
のうかがく	脳科学
のうおんか	濃音化
のういがい	脳以外
のーとがた	ノート型
ねんれいさ	年令差	年齢差
ねんりょう	燃量	燃料
ねんぶつじ	念仏寺
ねんぴりつ	燃費率
ねんぴょう	年表
ねんぴけい	燃費計
ねんばらい	年払い
ねんのため	為念	念のため	念の為
ねんどまつ	年度末
ねんどない	年度内
ねんどしつ	粘土質
ねんちょう	年長	粘稠
ねんちゅう	年中
ねんちゃく	粘着
ねんだいき	年代記
ねんたんい	年単位
ねんじゅう	年中
ねんしょう	年商	年少	燃焼
ねんしゅつ	捻出
ねんしゅう	年収
ねんきゅう	年給	年休
ねんがっぴ	年月日
ねんかいひ	年会費
ねんいちど	年一度
ねりまかん	練馬間
ねりまえき	練馬駅
ねらいうち	狙い打ち	狙い撃ち
ねやがわし	寝屋川市
ねもとけん	根元研
ねむろえき	根室駅
ねむりひめ	眠り姫
ねまちづき	寝待月
ねほしょう	根保証
ねぶかねぎ	根深葱
ねびきりつ	値引率	値引き率
ねびきすう	値引数
ねばりづよ	粘り強
ねばりごし	粘り腰
ねなりがき	根成柿
ねなしぐさ	根無草	根無し草
ねていとう	根抵当
ねつりょう	熱量
ねつりゅう	熱流
ねつゆそう	熱輸送
ねつへんか	熱変化
ねつびょう	熱病
ねつでんし	熱電子
ねつそくど	熱速度
ねつじょう	熱情
ねつしょり	熱処理
ねつさまし	熱冷まし
ねつきかん	熱機関
ねつかんわ	熱緩和
ねっぷうろ	熱風炉
ねっちゅう	熱中
ねったいや	熱帯夜
ねっしょう	熱傷	熱唱
ねっきょう	熱狂
ねっきゅう	熱球
ねだんぶん	値段分
ねだんとう	値段等
ねだんてき	値段的
ねずみどし	子年
ねずみとり	ネズミ捕り	鼠捕り
ねずみたち	鼠達
ねずみざん	鼠算
ねずみこう	ネズミ講	ねずみ講	鼠講
ねずみいろ	鼠色
ねごろばん	根来版
ねこやなぎ	猫柳
ねこめいし	猫目石
ねこむすめ	猫娘
ねこまたぎ	猫跨ぎ
ねこだまし	猫騙し
ねこじまん	猫自慢
ねこぐるま	猫車
ねこかぶり	猫被り
ねこいらず	猫いらず
ねぎぼうず	葱坊主
ねぎしせん	根岸線
ねきりむし	根切虫
ねがわくば	願わくば
ねがさかぶ	値嵩株
ねがいさげ	願い下げ
ねがいごと	願い事
ねおじうむ	Nd
ねえちゃん	姉ちゃん
ねいりばな	寝入り端
ねーちゃん	ネーちゃん
ぬればいろ	濡羽色	濡れ羽色
ぬれねずみ	濡れ鼠
ぬれたおる	濡れタオル
ぬりぐすり	塗薬	塗り薬
ぬまべえき	沼部駅
ぬまづこう	沼津港
ぬまずこう	沼津港
ぬまくない	沼宮内
ぬのぶくろ	布袋
ぬすみよみ	盗み読み
ぬすみぐい	盗み食い
ぬすみぎき	盗み聞き
ぬきうつし	抜写し
ぬかぶくろ	糠袋
ぬかびらこ	糠平湖
ぬかばたら	糠働
にんようご	任用後
にんぴょう	任憑
にんぴにん	人非人
にんていか	認定課
にんていい	認定医
にんちゅう	人中
にんちてき	認知的
にんそうみ	人相見
にんずうひ	人数比
にんじょう	刃傷	人情
にんじゅつ	忍術
にんじゅう	忍従
にんしんじ	妊娠時
にんしょう	人証	人称	認照	認証
にんしゅう	人衆
にんしきぶ	認識部
にんしきど	認識度
にんさんぷ	妊産婦
にんげんみ	人間味
にんぎょう	人形
にんきょう	仁侠	任侠
にんきもの	人気者
にんきばん	人気盤
にんきとり	人気取り
にんきかん	人気館
にんきうま	人気馬
にんきうす	人気薄
にんきいか	人気以下
にんかせい	認可制
にんいせい	任意性
にんいかい	任意回
にわかゆき	俄雪
にわかあめ	瀑	俄雨	にわか雨
にれんぱつ	二連発
にるいしゅ	二塁手
にるいけい	二類型
にりんよう	二輪用
にりんしゃ	二輪車
にりゅうか	二硫化
にらんせい	二卵性
にらめっこ	睨めっこ
にらみかえ	睨み返
にらみあい	睨み合い
にょやしゃ	如夜叉
にょぼさつ	如菩薩
にょしょう	女将	女性
にょうもれ	尿漏れ
にょうまく	尿膜
にょうぼう	女房
にょうはち	鐃鉢
にょうどう	尿道
にょうさん	尿酸
にょうかん	尿管
にょういん	女院
にょいぼう	如意棒
にゅうろう	入牢
にゅうりん	乳輪
にゅうらく	乳酪	入洛
にゅうらい	入来
にゅうよく	入浴	入欲
にゅうよう	乳用	入用
にゅうもん	入門
にゅうめん	煮麺	入麺
にゅうめつ	入滅
にゅうみん	入眠
にゅうまく	入幕
にゅうぼう	乳房	乳棒
にゅうばち	乳鉢
にゅうばい	入梅
にゅうねん	入念
にゅうない	入内
にゅうどう	入道
にゅうとう	入湯	入党	入刀	乳頭	乳糖
にゅうでん	入電
にゅうてん	入店
にゅうてい	入廷
にゅうだん	入団
にゅうたい	入隊	入体	入退
にゅうそう	入槽
にゅうぜん	入善
にゅうせん	入船	入選	入線	乳腺
にゅうせき	入籍
にゅうすい	入水
にゅうじき	乳児期
にゅうしん	入心	入信	入神
にゅうしょ	入所
にゅうしゅ	入手
にゅうしゃ	入射	入舎	入社
にゅうしつ	入室
にゅうしち	入質
にゅうしか	入試課
にゅうざん	入山
にゅうざい	乳剤
にゅうさん	乳酸
にゅうさつ	入札
にゅうごく	入獄
にゅうこん	入魂
にゅうこじ	入庫時
にゅうこく	入国
にゅうこう	入構	乳香	入坑	入稿	入貢	入港	入校
にゅうぎょ	入御	入漁
にゅうきん	入金
にゅうきょ	入居	入渠
にゅうがん	乳癌
にゅうがく	入学
にゅうかん	入棺	乳管	入管	入館	入感
にゅうかわ	丹生川
にゅうかく	入閣
にゅうかい	入会
にゅうえん	入園
にゅうえき	乳液
にゅうえい	入営
にゅううん	乳暈
にゅういん	入院
にやっかい	荷厄介
にゃくどう	若道
にもつよう	荷物用
にもつしつ	荷物室
にもつごと	荷物毎
にもうさく	二毛作
にめんせい	二面性
にまんえん	二万円
にまいじた	二枚舌
にまいごし	二枚腰
にまいげり	二枚蹴り
にまいぐみ	二枚組
にまいがい	二枚貝
にほんよう	日本用
にほんやく	日本訳
にほんもの	日本物
にほんめい	日本名
にほんむけ	日本向
にほんまる	日本丸
にほんまつ	二本松
にほんまち	日本町
にほんまい	日本米
にほんへん	日本編
にほんぶん	日本文
にほんふう	日本風
にほんばん	日本盤	日本版
にほんばれ	日本晴れ
にほんばし	日本橋
にほんはむ	日本ハム
にほんはつ	日本発	日本初
にほんねこ	日本猫
にほんなみ	日本並
にほんない	日本内
にほんとう	日本刀
にほんてき	日本的
にほんつう	日本通
にほんちゃ	日本茶
にほんちず	日本地図
にほんちく	日本地区
にほんだて	二本建
にほんだい	日本大
にほんぜい	日本勢
にほんせん	‖
にほんせい	日本製
にほんじん	日本人
にほんしん	日本新
にほんしゅ	日本酒
にほんしゃ	日本車
にほんしぶ	日本支部
にほんしき	日本式
にほんざる	日本猿
にほんざし	二本差し
にほんさん	日本産	日本サン
にほんごま	日本語混
にほんごか	日本語化	日本語可
にほんごう	日本語打
にほんこく	日本国	日本國
にほんこう	日本校
にほんけん	日本犬
にほんぐん	日本軍
にほんきか	日本帰化
にほんがわ	日本側
にほんがみ	日本髪
にほんがた	日本型
にほんがく	日本学
にほんかん	日本館	日本間
にほんかぶ	日本株
にほんかい	日本海
にほんえん	日本円
にほんいち	日本一
にほんあし	二本足
にほてまえ	二歩手前
にほうせい	二峰性
にへんすう	2変数
にぶんほう	2分法	二分法
にぶおんぷ	２分音符	二分音符
にふくつい	二幅対
にびょうし	二拍子
にばんせん	二番煎
にばんせき	二番席
にばんかん	二番館
にのかまえ	二構え	二構
にねんまえ	二年前
にねんせい	二年生	2年生
にねんかん	二年間
になんせん	日南線
にとうへい	二等兵
にとうぶん	2等分	二等分
にとうだて	二頭立て
にとうしん	二頭身
にとうしゃ	二等車
にとうきん	二頭筋
にづくりひ	荷造費
にっぽんご	日本語
にっぴょう	日評
にっちょく	日直
にっちょう	日朝
にっちゅう	日中
にっしょく	日食	日蝕
にっしょう	日商	日照	日章
にっしゅつ	日出
にっしゅう	日周	日収
にっこうき	日航機
にっきょう	日共
にっきゅう	日給
にっきふう	日記風
にっきそう	日機装
にっかんし	日刊紙
にっかゆし	日華油脂
にちりんし	日林誌
にちりょう	日糧
にちようび	日曜日
にちょうめ	二丁目
にちょうな	二丁投
にちぼつご	日没後
にちなんし	日南市
にちどくい	日独伊
にちじょう	日常
にちじゅう	日中
にちがぞう	二値画像
にちいだい	日医大
にだんぐみ	二段組
にだんかい	二段階	2段階
にせんしき	二線式
にせんえん	二千円
にじんえい	二陣営
にじりぐち	躙り口
にじよせん	二次予選
にじょうわ	２乗和	二乗和
にじょうき	二畳紀
にじゅうし	二十四
にじゅうか	二重化
にじもくぶ	二次木部
にじみゃく	二次脈
にじはいふ	二次配布
にじでんち	二次電池
にじっぴき	二十匹
にじっさい	二十歳
にじしよう	二次使用
にじしけん	二次試験
にじきおく	二次記憶
にじかこう	二次加工
にしんほう	二進法	２進法
にしんとう	二親等
にしんすう	2進数	二進数
にしわせだ	西早稲田
にしょうめ	二勝目
にしゅるい	二種類
にしやいづ	西焼津
にしゃかん	二者間
にしむらや	西村屋
にしみなみ	西南
にしまごめ	西馬込
にしほだか	西穂高
にしのみや	西宮
にしのはら	西野原	西之原
にしのその	西之園
にしのしま	西ノ島
にしのうち	西の内
にしにほん	西日本
にしどうろ	西道路
にしどいつ	西独	西ドイツ
にしとなみ	西砺波	西礪波
にしつがる	西津軽
にしだいら	西平
にししらい	西白井
にしざおう	西蔵王
にしごうし	西合志
にしこやま	西小山
にしこくら	西小倉
にしこうべ	西神戸
にしくわな	西桑名
にしくびき	西頚城
にしぎんざ	西銀座
にしきどう	錦堂
にしきごい	錦鯉
にしきぎか	Celastraceae	ニシキギ科
にしがいち	西垣内
にしかんだ	西神田
にしかつら	西桂
にしかしま	西鹿島
にしかさい	西葛西
にしおおつ	西大津
にしおおじ	西大路
にしおおい	西大井
にしうめだ	西梅田
にしうすき	西臼杵
にしいわい	西磐井
にしありた	西有田
にしありえ	西有家
にしあらい	西新井
にしあまね	西周
にしあじあ	西アジア
にしあざぶ	西麻布
にしあざい	西浅井
にしあかし	西明石
にしあいづ	西会津
にざえもん	仁左衛門
にさんにち	２、３日	二三日
にさぶんし	二叉分枝
にさつぶん	二冊分
にさくひん	二作品
にごりざけ	濁り酒
にごしらえ	荷拵え
にごうかん	二号館
にころがし	煮転がし
にこくかん	二国間
にげんろん	二元論
にげんてき	二元的
にげんしゃ	二玄社
にげんきん	二弦琴
にげじたく	逃げ支度
にくやさい	肉野菜
にくぶとん	肉蒲団
にくばなれ	肉離れ
にくだんご	肉団子
にくたらし	憎たらし
にくたいび	肉体美
にくたいは	肉体派
にくずくか	ニクズク科	Myristicaceae
にくじゅう	肉汁
にくしょく	肉色	肉食
にくぎゅう	肉牛
にくきゅう	肉球
にくがかり	肉係
にぎりめし	握り飯
にぎりつぶ	握り潰
にぎりずし	握り鮨
にきょくめ	二曲目
にきょくか	二極化
にがわらい	苦笑い
にがよもぎ	苦艾
にがみばし	苦み走
にかめいが	二化螟蛾
にかこくご	二ヶ国語
にかいどう	二階堂
にかいだて	二階建	二階建て
にかいせん	二回戦
にかいせき	二階席
におうみや	匂宮
におうふく	二往復
におうだち	仁王立ち
にうけにん	荷受人
にいんせい	二院制
にいるぴと	二色人
にいまくら	新枕
にいちゃん	兄ちゃん
にいじょう	二以上
にいがたし	新潟市
にいかっぷ	新冠
にあつかい	荷扱い
なんれんさ	何連鎖
なんりょう	何両
なんようび	何曜日
なんみんく	難民区
なんぼんめ	何本目
なんぼいん	軟母音
なんぷくじ	南福寺
なんぶせん	南武線
なんぴょう	何票
なんびょう	何秒	難病
なんびゃく	何百
なんひょう	何票
なんぱつめ	何発目
なんぱせん	難破船
なんばんめ	何番目
なんばんづ	南蛮漬
なんばんち	何番地
なんばりき	何馬力
なんねんめ	何年目
なんねんご	何年後
なんにんめ	何人目
なんにちめ	何日目
なんにちご	何日後
なんどいろ	納戸色
なんとなく	何となく
なんとおり	何通り
なんとうは	軟投派
なんでもや	何でも屋
なんてんぽ	何店舗
なんてんか	ナンテン科	Nandinaceae
なんつうめ	何通目
なんちょう	軟調	難聴	南朝	何丁
なんちゅう	南中
なんちゃく	何着
なんだばつ	何打罰
なんたんい	何単位
なんそしき	軟組織
なんぜんじ	南禅寺
なんせんめ	何戦目
なんせだい	何世代
なんせいぶ	南西部
なんせいき	何世紀
なんじょう	何乗	南条	何条	南城	南條	南常
なんじゅう	何十	何重	難渋
なんじゃく	軟弱
なんじごろ	何時頃
なんじころ	何時頃
なんじけん	難事件
なんじかん	何時間
なんしょく	何色	男色	難色
なんしょう	難症	南昌	何勝
なんしゅう	南州	何週	何周
なんしあい	何試合
なんさくめ	何作目
なんくかん	何区間
なんぎょう	何行	難業	難行
なんきんし	南京市
なんきょく	難曲	何局	何曲	難局	南極
なんきょう	難境
なんきゅう	軟球
なんきごう	南紀号
なんがめん	何画面
なんかんめ	何巻目
なんかしょ	何ヵ所	何か所	何箇所	何カ所	何ヶ所
なんかげつ	何ヶ月	何か月	何カ月	何箇月
なんかいめ	何回目
なんいない	何位内
なわばしご	縄梯子
なわのれん	縄暖簾
なわしろだ	苗代田
なれのはて	成れの果
なるとまき	鳴門巻
なるとだい	鳴門鯛
なるせだい	成瀬台
なりものし	鳴物師
なりひさご	生り瓢
なりたびん	成田便
なりたはつ	成田発
なりたにし	成田西
なりたせん	成田線
なりたずし	成田逗子
なりたかん	成田間
なりかたち	形姿
なりあきら	斉彬
なりあがり	成り上がり
なりあいじ	成相寺
ならべかえ	並べ変え	並べ替え
ならびかえ	並び換え
ならちょう	奈良町
ならずもの	ならず者
ならじだい	奈良時代
ならしのし	習志野市
ならしない	奈良市内
ならしてん	奈良支店
ならえほん	奈良絵本
ならいごと	習い事
なめりかわ	滑川
なみまくら	波枕
なみはずれ	並外れ
なみだもろ	涙脆
なみだもの	涙もの	涙モノ
なみだごえ	涙声
なみだきん	涙金
なみだがわ	涙川
なみだがた	涙型
なみだがお	涙顔
なみだあめ	涙雨
なみしょう	浪商
なみきみち	並木道
なみがしら	波頭
なまりぶし	生り節
なまりばん	鉛版
なまりだん	鉛弾
なまりいろ	鉛色
なまりいり	鉛入
なまりいた	鉛板
なまやさい	生野菜
なまめかし	艶かし
なまへんじ	生返事
なまはんか	生半可
なまはけい	生波形
なまっちろ	生っ白
なまたまご	生卵
なますじこ	生筋子
なまじゃけ	生鮭
なまじっか	憖っか
なましょく	生食
なまざかな	生魚
なまごろし	生殺し
なまけもの	怠け者
なまけぐせ	怠け癖
なまがわき	生乾き
なまがっき	生楽器
なまかじり	生齧り
なまおぼえ	生覚え
なまえよう	名前用
なまえまけ	名前負け
なまえいり	名前入
なまあたた	生暖
なほもって	尚以て
なぶりもの	嬲り者
なばりせん	名張線
なはしない	那覇市内
なはしでん	那覇市電
なにわぶし	浪花節
なにもよう	何模様
なにばしょ	何場所
なにかんが	何考
なにうりば	何売場
ななやしろ	七社
ななめまえ	斜め前
ななめした	斜め下
ななめうえ	斜め上
ななまがり	七曲り
ななふしぎ	七不思議
ななひかり	七光
ななねんめ	七年目
ななつもり	七ッ森
ななつぼし	七つ星
ななつたき	七ッ滝
ななじょう	七条
ななしょく	七色
ななころび	七転び
ななおせん	七尾線
なとりうむ	Na	Sodium
なづけおや	名付け親	名付親
なつやすみ	夏休	夏休み
なつやさい	夏野菜
なつめやし	棗椰子
なつみかん	夏蜜柑
なつまつり	夏祭り	夏祭
なつばしょ	夏場所
なつばおり	夏羽織
なつのじん	夏の陣
なつぜんご	夏前後
なつじゅう	夏中
なつじかん	夏時間
なつしんぽ	夏シンポ
なつごろも	夏衣
なつくいな	夏水鶏
なつおんな	夏女
なついがい	夏以外
なっとくい	納得行
なだれしき	雪崩式
なだめすか	宥め賺
なだちゅう	灘中
なたしょう	名田庄
なじみぶか	馴染み深
なしくずし	済し崩し
なさぬなか	生さぬ仲
なさけぶか	情け深
なごやべん	名古屋弁
なごやはつ	名古屋発
なごやにし	名古屋西
なごやちく	名古屋地区
なごやだい	名古屋大
なごやせん	名古屋線
なごやじん	名古屋人
なごやしぶ	名古屋支部
なごやぐち	名古屋口
なごやえき	名古屋駅
なげきっす	投げキッス
なぐりたお	殴り倒
なぐりころ	殴り殺
なぐりがき	殴り書き
なぐさめあ	慰め合
なきわらい	泣き笑い
なきわかれ	泣き別れ
なきりゅう	鳴き竜	鳴竜
なきりすげ	菜切菅
なきぼくろ	泣き黒子
なきねいり	泣き寝入り
なきどころ	泣き所
なきっつら	泣きっ面
なきおんな	泣き女	泣女
なきおとし	泣落し
ながれやま	流山
ながれもの	流れ者
ながれぼし	流れ星
ながれある	流れ歩
ながらがわ	長良川
ながやおう	長屋王
ながひばち	長火鉢
ながばなし	長話
ながばかま	長袴
ながのはら	長野原
ながのどう	長野道
ながのだい	長野大
ながのこう	長野高
ながのけん	長野県
ながのがわ	長野側
ながのえき	長野駅
ながでんわ	長電話
ながづくえ	長机
ながつづき	長続き	永続き
ながっちり	長っ尻
ながだんぎ	長談義
ながずぼん	長ズボン
ながしだい	流し台
ながしずき	流し漉き
ながしかく	長四角
ながさきや	長崎屋
ながさきし	長崎市
ながおだい	長尾台
ながおせん	長尾線
ながおかし	長岡市
ながいずみ	長泉
なかんずく	就中
なかりゃく	中略
なかやすみ	中休み
なかやしき	中屋敷
なかめぐろ	中目黒
なかむらや	中村屋
なかむらし	中村市
なかむらく	中村区
なかみなと	那珂湊
なかみかわ	中見川
なかみかど	中御門
なかまわれ	仲間割れ
なかまはず	仲間外
なかまたち	仲間達
なかまうち	仲間内
なかまいり	仲間入り	仲間入
なかびしゃ	中飛車
なかひがし	中東
なかばやし	中林
なかはらく	中原区
なかのだい	中野台
なかのしま	中之島	中野島
なかのくち	中之口
なかのえき	中野駅
なかにほん	中日本
なかにいだ	中新田
なかなおり	仲直り
なかとがわ	中戸川
なかつやま	中津山
なかつくに	中つ国
なかつがわ	中津川
なかつがる	中津軽
なかつかさ	中務
なかちょう	仲町	中長
なかだるみ	中だるみ	中弛み
なかだいら	中平
なかたじま	中田島
なかたがい	仲違い	仲たがい
なかじょう	中条	中條
なかじゅく	中宿
なかしょく	中食
なかしょう	中庄
なかしほろ	中士幌
なかしべつ	中標津
なかざいけ	中在家
なかさんげ	中山下
なかこうじ	中小路	仲小路
なかぐすく	中城
なかぎょう	中京
なかがわら	中河原
なかかわね	中川根
なかおもて	中表
なかいみほ	中井美穂
なかいえき	中井駅
なかあだち	中阿達
なおしかた	直し方
なえばやま	苗場山
ないりんさ	内輪差
ないりょく	内力
ないりくぶ	内陸部
ないようぶ	内容部
ないようは	内容派
ないやせき	内野席
ないやじん	内野陣
ないやしゅ	内野手
ないもうこ	内蒙古
ないめんか	内面化
ないぶんぴ	内分泌
ないぶてき	内部的
ないぶせん	内部線
ないぶせい	内部生
ないねんき	内燃機
ないにゅう	内乳
ないていひ	内廷費
ないぞうき	内蔵機
ないせいり	内整理
ないじょう	内情
ないじえん	内耳炎
ないしょく	内職
ないしょう	内障	内省	内証	内鞘	内相
ないしゅう	内周
ないしゃく	内借	内戚
ないざいか	内在化
ないきょく	内局
ないがめん	内画面
ないがしろ	蔑ろ
ないかくふ	内閣府
なーすふく	ナース服
のるうぇーご	ノルウェー語
のりものよい	乗物酔い	乗り物酔い
のりものけん	乗物券
のりべんとう	海苔弁当
のりつぎえき	乗継駅
のりこしえき	乗越駅
のりくらだけ	乗鞍岳
のりくみいん	乗組員
のりかえぐち	乗換口
のりかええき	乗換駅
のりいれがみ	糊入紙
のむぎとうげ	野麦峠
のみほうだい	飲み放題
のぼりとえき	登戸駅
のべにんずう	延人数
のべにっすう	延べ日数
のべじんいん	延べ人員
のべおかかん	延岡間
のとはんとう	能登半島
のだはんしん	野田阪神
のせでんしゃ	能勢電車
のぐちひでよ	野口英世
のぎわようこ	野際陽子
のぎまれすけ	乃木希典
のおがたえき	直方駅
のうりょくち	能力値
のうりょくさ	能力差
のうりつてき	能率的
のうやくしゃ	能役者
のうみんふう	農民風
のうまくえん	脳膜炎
のうふきげん	納付期限
のうひんまち	納品待ち
のうひんしょ	納品書
のうひんさき	納品先
のうひんけつ	脳貧血
のうにゅうじ	納入時
のうにゅうか	納入価
のうどうてき	能動的
のうどうたい	能動態
のうそくせん	脳塞栓
のうぜいしょ	納税書
のうぜいしゃ	納税者
のうせんかた	納銭方
のうしんとう	脳震盪
のうしんけい	脳神経
のうしゅよう	脳腫瘍
のうしゅくど	濃縮度
のうしゃまえ	納車前
のうしゃかい	納射会
のうざしょう	脳挫傷
のうさんぶつ	農産物
のうさんひん	農産品
のうさつじょ	納札所
のうさくもつ	農作物
のうさくぶつ	農作物
のうさぎょう	農作業
のうさいぼう	脳細胞
のうこつどう	納骨堂
のうこうよう	農耕用
のうこうみん	農耕民
のうこうだい	農工大
のうこうそく	脳梗塞
のうけっせん	脳血栓
のうぎょうか	農業科
のうきょけつ	脳虚血
のうがくどう	能楽堂
のうかんけい	脳関係
のうかがくぶ	脳科学部
のうかいだい	能開大
のういっけつ	脳溢血
のーべりうむ	No	Nobelium
ねんれいべつ	年令別	年齢別
ねんれいてき	年齢的
ねんれいそう	年齢層
ねんりょうひ	燃料費
ねんりまわり	年利回り
ねんまくめん	粘膜面
ねんぽうせい	年俸制
ねんぱいしゃ	年配者
ねんばんがん	粘板岩
ねんどきかく	粘度規格
ねんだんせい	粘弾性
ねんだいもの	年代物
ねんだいべつ	年代別
ねんじすいい	年次推移
ねんしょらい	年初来
ねんしょうど	燃焼度
ねんしまわり	年始回り
ねんけいかく	年計画
ねんきんほう	年金法
ねんきゅうぼ	年休簿
ねんがはがき	年賀葉書
ねんがじょう	年賀状
ねんえきしつ	粘液質
ねんいっかい	年一回
ねんいじょう	年以上
ねるちんすく	尼布楚
ねりようかん	練り羊羹	煉り羊羹	練羊羹
ねりまくみん	練馬区民
ねりせいひん	練製品	練り製品	煉り製品
ねものがたり	寝物語
ねむりびょう	眠り病
ねむりぐすり	眠り薬
ねむけざまし	眠気覚まし
ねみみにみず	寝耳に水
ねほりはほり	根掘り葉掘り
ねぷつにうむ	Np	Neptunium
ねづじんぱち	根津甚八
ねつりきがく	熱力学
ねつぼうそう	熱暴走
ねつへんせい	熱変性
ねつへいこう	熱平衡
ねつふくしゃ	熱輻射
ねつはっせい	熱発生
ねつはっさん	熱発散
ねつでんどう	熱伝導
ねつでんつい	熱電対
ねつてんしゃ	熱転写
ねつていこう	熱抵抗
ねつたいさく	熱対策
ねつそんしつ	熱損失
ねつこうりつ	熱効率
ねつこうかん	熱交換
ねつけいれん	熱痙攣
ねつききゅう	熱気球
ねつうんどう	熱運動
ねっとじょう	ネット上
ねったいりん	熱帯林
ねったいせい	熱帯性
ねったいさん	熱帯産
ねったいぎょ	熱帯魚
ねっけつかん	熱血漢
ねっききゅう	熱気球
ねだんふめい	値段不明
ねだんひょう	値段表
ねだんいがい	値段以外
ねずみこぞう	鼠小僧
ねずみがえし	鼠返し
ねずみおとこ	鼠男
ねしょんべん	寝小便
ねしょうべん	寝小便
ねしょうがつ	寝正月
ねこのひたい	猫の額
ねこなでごえ	猫撫で声	猫なで声
ねこかんけい	猫関係
ねぎとろどん	ねぎとろ丼
ねぎしちょう	根岸町
ねあがりまつ	根上り松
ぬまたちょう	沼田町
ぬまずひがし	沼津東
ぬのはらえき	布原駅
ぬのいちまち	布市町
ぬかみそづけ	糠味噌漬
ぬかばたらき	糠働き
にんめいけん	任命権
にんとうぜい	人頭税
にんてんどう	仁天堂	任天堂
にんていひん	認定品
にんていしゃ	認定者
にんていこう	認定校
にんていきき	認定機器
にんちりろん	認知理論
にんちもでる	認知モデル
にんちとどけ	認知届
にんちしんり	認知心理
にんちしょり	認知処理
にんちきのう	認知機能
にんちきこう	認知機構
にんちかてい	認知過程
にんちかがく	認知科学
にんそうがく	人相学
にんずうぶん	人数分
にんずうてき	人数的
にんじょうみ	人情味
にんじゃやく	忍者役
にんじゃもの	忍者物
にんじゃでら	忍者寺
にんしきろん	認識論
にんしきりつ	認識率
にんしきよう	認識用
にんしきけい	認識系
にんしきがく	認識学
にんげんわざ	人間技	人間業
にんげんよう	人間用
にんげんばな	人間離
にんげんなみ	人間並
にんげんてき	人間的
にんげんたち	人間達
にんげんぞう	人間像
にんげんせい	人間性
にんげんさま	人間様
にんげんぎら	人間嫌
にんげんがわ	人間側
にんげんがた	人間型
にんげんがく	人間学
にんげんかん	人間観
にんげんかい	人間界
にんげんあい	人間愛
にんぎょひめ	人魚姫
にんぎょでん	人魚伝
にんぎょうし	人形師
にんぎょうか	人形化
にんきひりつ	人気比率
にんきていか	人気低下
にんきちゅう	任期中
にんきじゅん	人気順
にんきさっか	人気作家
にんききしゅ	人気機種
にんいほけん	任意保険
にんいほうき	任意法規
にんいちょう	任意長
にんいだいり	任意代理
にんいそうさ	任意捜査
にんいせいり	任意整理
にんいこすう	任意個数
にんいきてい	任意規定
にんいかくど	任意角度
にわかじたて	俄仕立て
にわかじこみ	俄仕込み
にれつごせい	二列互生
にりんくどう	二輪駆動
にょたいもり	女体盛り
にょぜがもん	如是我聞
にょうけんさ	尿検査
にゅうりょく	入力
にゅうりょう	入寮
にゅうようじ	乳幼児
にゅうもんき	入門機
にゅうちょう	入超	入朝
にゅうちゃく	入着
にゅうだんじ	入団時
にゅうだんご	入団後
にゅうじょう	乳状	入城	入定	入場
にゅうじゅく	入塾
にゅうじゅう	乳汁
にゅうじゃく	入寂	柔弱
にゅうしょく	入植
にゅうしょう	入省	入賞
にゅうしゅつ	入出
にゅうしゅご	入手後
にゅうしゅか	入手可
にゅうしゃび	入社日
にゅうしゃは	入射波
にゅうしゃじ	入社時
にゅうしゃご	入社後
にゅうしぼう	乳脂肪
にゅうこすう	入庫数
にゅうこくび	入国日
にゅうこくじ	入国時
にゅうこくご	入国後
にゅうぎょく	入玉
にゅうぎょう	乳業
にゅうぎゅう	乳牛
にゅうきょう	入京	入鋏
にゅうきゅう	入厩
にゅうがくじ	入学時
にゅうがくご	入学後
にゅうかまち	入荷待ち
にゅうかすう	入荷数
にゅうかざい	乳化剤
にゅうかいひ	入会費
にゅうかいじ	入会時
にゅうかいご	入会後
にゅういんひ	入院費
にゅーよーく	紐育
にもつとびら	荷物扉
にもつせいり	荷物整理
にもつけんさ	荷物検査
にもつおきば	荷物置場
にまいめやく	二枚目役
にまいがさね	二枚重ね
にまいおろし	二枚下ろし
にほんりょう	日本領
にほんりゅう	日本流
にほんむせん	日本無線
にほんむかし	日本昔
にほんぶんか	日本文化
にほんぶよう	日本舞踊
にほんぶもん	日本部門
にほんぶどう	日本武道
にほんふたん	日本負担
にほんどくじ	日本独自
にほんでんし	日本電子
にほんでんき	日本電気
にほんてれび	日本テレビ
にほんづつみ	日本堤
にほんだんし	日本男子
にほんだいら	日本平
にほんたたき	日本叩き
にほんそーだ	日本曹達
にほんぜんど	日本全土
にほんせきゆ	日本石油
にほんせいふ	日本政府
にほんじんず	日本人好
にほんじょし	日本女子
にほんじゅう	日本中
にほんじかん	日本時間
にほんしんわ	日本神話
にほんしよう	日本仕様
にほんしょく	日本食
にほんしょき	日本書紀	日本書記
にほんしょう	日本賞
にほんしゅど	日本酒度
にほんしほん	日本資本
にほんししゃ	日本支社
にほんさんば	日本産馬
にほんさんそ	日本酸素
にほんさいご	日本最後
にほんさいこ	日本最古
にほんごろん	日本語論
にほんごよう	日本語用
にほんごやく	日本語訳
にほんごもじ	日本語文字
にほんごめん	日本語面
にほんごめい	日本語名
にほんごぶん	日本語文
にほんごふう	日本語風
にほんごばん	日本語版
にほんごつう	日本語通
にほんごがく	日本語学
にほんごおん	日本語音
にほんこゆう	日本固有
にほんきろく	日本記録
にほんきいん	日本棋院
にほんがいし	日本ガイシ	日本碍子
にほんかやく	日本化薬
にほんかくち	日本各地
にほんえいが	日本映画
にほんいだい	日本医大
にほんいがい	日本以外
にひゃくつう	二百通
にばんちょう	二番町
にばんだしゃ	二番打者
にばんせんじ	二番煎じ
にはくみっか	二泊三日
にぬきたまご	煮抜き玉子
ににんしょう	二人称
にとうわしつ	二等和室
にとうりゅう	二刀流
にてんとうし	二点透視
にっぽんばし	日本橋
にっぽんはむ	日本ハム
にっぽんじん	日本人
にっぽんしん	日本新
にっぽんしき	日本式
にっぽんこく	日本国
にっぽんこう	日本校
にっぽんかん	日本間
にっぽんかい	日本海
にっぽんいち	日本一
にっぽじしょ	日葡辞書
にっぽうせん	日豊線
にっとうぼう	日東紡
にっていてき	日程的
にったいだい	日体大
にっしょうき	日章旗
にっさんしゃ	日産車
にっころがし	煮っ転がし
にっこうよく	日光浴
にっこうせん	日光線
にっこうがわ	日光側
にっこうえき	日光駅
にっけいれん	日経連
にっけいじん	日系人
にっきょうそ	日教組
にっきちょう	日記帳
にっきしゅう	日記集
にっかんこう	日刊工
にっかじへん	日華事変
にっかぎれん	日科技連
にちりんろん	日林論
にちようよる	日曜夜
にちようぶん	日曜分
にちようひん	日用品
にちようばん	日曜版
にちようはつ	日曜発
にちようごご	日曜午後
にちようあさ	日曜朝
にちょうなげ	二丁投げ
にちぼつまえ	日没前
にちぼうしん	日貿信
にちべんれん	日弁連
にちべいかん	日米間
にちべいおう	日米欧
にちのうけん	日能研
にちにちそう	日日草
にちでんばん	日電版
にちでんせい	日電製
にちじょうご	日常語
にだんがさね	二段重ね
にたんちょう	ニ短調
にたにゆりえ	二谷友里恵
にそくほこう	二足歩行
にせんきゅう	二線級
にせたんてい	偽探偵
にせけいかん	偽警官
にじりゅうし	2次粒子
にじょうほう	二乗法
にじょうごさ	二乗誤差
にじゅっぴき	二十匹
にじゅっさい	二十歳
にじゅうわく	二重枠
にじゅうまん	二十万
にじゅうまる	◎	二重丸
にじゅうまど	二重窓
にじゅうばし	二重橋
にじゅうねん	二十年
にじゅうにし	二十二史
にじゅうだい	二十代
にじゅうそう	二重奏
にじゅうせん	二重線	2重線
にじゅうせい	二重性
にじゅうしし	二十四史
にじゅうごし	二十五史
にじゅうかん	二重管
にじゅうかべ	二重壁
にじゅううつ	二重写
にじゅうあご	二重顎
にじばいあす	二次バイアス
にじとうごう	二次統合
にじでんせつ	虹伝説
にじていすう	二時定数
にじっせいき	二十世紀
にじたいしゃ	二次代謝
にじしりょう	二次資料
にじげんてき	二次元的
にじかんせん	二次巻線	二次感染
にじかんすう	二次関数
にじおんげん	2次音源
にしわかまつ	西若松
にしよどがわ	西淀川
にしよこはま	西横浜
にしよこづな	西横綱
にしょうてん	二焦点
にしゅうかん	2週間	二週間
にしやつしろ	西八代
にしもろかた	西諸県
にしめいはん	西名阪
にしむらやま	西村山
にしまつうら	西松浦
にしまいづる	西舞鶴
にしほんまち	西本町
にしほうめん	西方面
にしふなばし	西船橋
にしびわじま	西枇杷島
にしはんぶん	西半分
にしのみやし	西宮市
にしのだいら	西の平
にしのきょう	西の京
にしのおもて	西之表
にしにほんご	西日本語
にしにっぽん	西日本
にしにっぽり	西日暮里
にしとさむら	西土佐村
にしてつびん	西鉄便
にしださちこ	西田佐知子
にしたんざわ	西丹沢
にしたてやま	西館山	西舘山
にしせんぼく	西仙北
にしせんだい	西仙台
にしせきわけ	西関脇
にしじんおり	西陣織
にししらかわ	西白河
にししおがま	西塩釜
にしさんどう	西参道
にしさんそう	西三荘
にしごたんだ	西五反田
にしこむすび	西小結
にしこまごめ	西駒込
にしこうえん	西公園
にしくにさき	西国東
にしくじょう	西九条
にしぎょうく	西京区
にしきりゅう	西桐生
にしきちょう	錦町
にしきぎもく	ニシキギ目	Celastrales
にしきがおか	錦ヶ丘
にしかんばら	西蒲原
にしかなざわ	西金沢
にしかつやま	西勝山
にしかすがい	西春日井
にしかごしま	西鹿児島
にしかいがん	西海岸
にしおちあい	西落合
にしおぎくぼ	西荻窪
にしおおたに	西大谷
にしいばらき	西茨城
にしあわくら	西粟倉
にしあおやま	西青山
にこうぶんぷ	二項分布
にこうていり	二項定理
にくろむせん	ニクロム線
にくりょうり	肉料理
にくようしゅ	肉用種
にくまれやく	憎まれ役
にくまれもの	憎まれ者
にくまれっこ	憎まれっ子
にくまれぐち	憎まれ口
にくだんせん	肉彈戰	肉弾戦
にくたいてき	肉体的
にくこっぷん	肉骨粉
にくかんてき	肉感的
にぎにぎしい	賑々しい
にきゅうひん	二級品
にきゅうしゅ	二級酒
にがてちゅう	苦手中
にかげつぶん	二箇月分	二カ月分
にかいていど	二回程度
におくりにん	荷送人
においぶくろ	匂袋
にえくりかえ	煮え繰り返
にいはるぐん	新治郡
にいなめさい	新嘗祭
にいざかまち	新坂町
にいがたてん	新潟店
にいがただい	新潟大
にいがたさん	新潟産
にいがたけん	新潟県
にいがたぐち	新潟口
にいがたかん	新潟間
にいがたえき	新潟駅
なんりょうめ	何両目
なんみんはん	難民班
なんまんまい	何万枚
なんまんねん	何万年
なんまんにん	何万人
なんまんてん	何万点
なんまんえん	何万円
なんぽうけい	南方系
なんぽうかぜ	南方風
なんぼくせん	南北線
なんぼくかん	南北間
なんべいせん	南米線
なんべいさん	南米産
なんべいけい	南米系
なんへんせい	何編成
なんぷんまち	何分待ち
なんぶしせん	南武支線
なんびゃっこ	何百個
なんばんづけ	南蛮漬
なんばんせん	何番線	南蛮船
なんばんじん	南蛮人
なんねんまえ	何年前
なんねんぶん	何年分
なんねんばん	何年版
なんねんせい	何年生	難燃性
なんねんがた	何年型
なんねんかん	何年間
なんねんうえ	何年上
なんにんぶん	何人分
なんにちまえ	何日前
なんにちぶん	何日分
なんにちづけ	何日付
なんにちごろ	何日頃
なんにちかん	何日間
なんなんとう	南南東
なんなんせい	南南西
なんどちょう	納戸町
なんどうせん	軟銅線
なんとなれば	何となれば	∵
なんとうせん	南東線
なんだんかい	何段階
なんだいもん	南大門
なんたいさん	男体山
なんぜんまん	何千万
なんぜんびき	何千匹
なんぜんねん	何千年
なんぜんにん	何千人
なんぜんつう	何千通
なんぜんえん	何千円
なんせいたん	南西端
なんせいしょ	南斉書
なんじゃくか	軟弱化
なんじっぷん	何十分
なんじってん	何十点
なんじっつう	何十通
なんじっけん	何十件
なんじっかい	何十回
なんじいこう	何時以降
なんしゅるい	何種類
なんしゅうめ	何周目
なんしゃしゅ	何車種
なんしつまい	軟質米
なんしあいめ	何試合目
なんざんだい	南山大
なんごうせん	何号線
なんごうしゃ	何号車
なんごうかん	何号館
なんこつぎょ	軟骨魚
なんこうまえ	楠公前
なんこうどう	南江堂
なんこうだい	南光台
なんこうがい	軟口蓋
なんぎょうめ	何行目
なんきんむし	南京虫
なんきんまめ	南京豆
なんきょくめ	何曲目
なんがつごろ	何月頃
なんがつごう	何月号
なんかんぶん	何巻分
なんかじょう	何箇条
なんかこくご	何か国語	何カ国語
なんかいてん	何回転
なんかいせん	何回線	南海戦
なんおくねん	何億年
なんおくかい	何億回
なんおくえん	何億円
なんおうふく	何往復
なんおうけい	南欧系
なるおきねん	鳴尾記念
なりものいり	鳴物入り
なりひらばし	業平橋
なりたりこん	成田離婚
なりかつよう	ナリ活用
ならほうめん	奈良方面
ならせんない	奈良線内
ならせんたん	奈良先端
ならこうつう	奈良交通
ならこうせん	奈良高専
ならけんみん	奈良県民
ならいしょう	習い性
なめくじうお	蛞蝓魚
なむさんぼう	南無三宝
なみたいてい	並大抵
なみうちぎわ	波内際	波打ち際	波打際
なまりぶくろ	鉛袋
なまほうそう	生放送
なまばんぐみ	生番組
なませっこう	生石膏
なまじゃしん	生写真
なましいたけ	生椎茸
なまげんこう	生原稿
なまかんせん	生観戦
なまかべいろ	生壁色
なまえんそう	生演奏
なまえひょう	名前表
なまえじたい	名前自体
なまえしてい	名前指定
なまえかんり	名前管理
なまえいがい	名前以外
なべぶぎょう	鍋奉行
なぶりごろし	嬲り殺し
なぱーむだん	ナパーム弾
なはこうつう	那覇交通
なはくうこう	那覇空港
なにはさてお	何は扨措
なにせんせい	何先生
ななめうしろ	斜め後ろ
ななつどうぐ	七つ道具
ななだいせん	七大戦
なでしこもく	ナデシコ目	Caryophyllales
なつめまさこ	夏目雅子
なつほんばん	夏本番
なつがっこう	夏学校
なっとくかん	納得感
なっとうまき	納豆巻	納豆巻き
なっとうきん	納豆菌
なだこうこう	灘高校
なたねあぶら	菜種油
なずらえうた	準え歌
なすもくぐん	ナス目群
なすしおばら	那須塩原
なすおんせん	那須温泉
なしのつぶて	梨の礫
なさけしらず	情け知らず
なごやまつり	名古屋祭
なごやばしょ	名古屋場所
なごやだいり	名古屋大理
なごやじょう	名古屋城
なごやしない	名古屋市内
なごやしてん	名古屋支店
なごやししゃ	名古屋支社
なごやいがい	名古屋以外
なこうどぐち	仲人口
なぐさめがお	慰め顔
なぐさみもの	慰み者	慰み物
なぎなたぼこ	長刀鉾
なぎなたほこ	長刀鉾
なぎなたがた	長刀形
なきじょうご	泣き上戸
ながわずらい	長患い	痼
ながやまえき	永山駅
ながもちうた	長持唄
ながまちえき	長町駅
ながはまかん	長浜間
ながのしない	長野市内
ながてぶくろ	長手袋
ながつだえき	長津田駅
ながちょうば	長丁場
ながたにえん	永谷園
ながたちょう	永田町
ながすくじら	長須鯨
ながさきわん	長崎湾
ながさきばん	長崎版
ながさきどう	長崎道
ながさきだい	長崎大
ながさきせん	長崎線
ながさきこう	長崎港
ながさきけん	長崎県
ながさきえき	長崎駅
ながけちょう	名掛丁
ながおとうげ	長尾峠
ながおかえき	長岡駅
ながいかふう	永井荷風
なかやまみほ	中山美穂
なかやましば	中山芝
なかむらけん	中村研
なかまはずれ	仲間外れ
なかまどうし	仲間同士
なかまいしき	仲間意識
なかびょうし	中表紙
なかはらえき	中原駅
なかのちょう	仲之町
なかのじょう	中之条
なかのしょう	中之庄	中ノ庄
なかのいとう	中野以東
なかのいせい	中野以西
なかにいかわ	中新川
なかとんべつ	中頓別
なかだちょう	中田町
なかだちにん	仲立人
なかだかおり	仲田薫理
なかせんどう	中山道	中仙道
なかずとばず	鳴かず飛ばず
なかじまけん	中島研
なかさつない	中札内
なかけちょう	名掛丁
なかがいにん	仲買人
なかがいうち	中谷内
なかいひでお	中井英夫
なおきしょう	直木賞
なおえつかん	直江津間
ないわくせい	内惑星
ないりんざん	内輪山
ないりくせい	内陸性
ないらんざい	内乱罪
ないようべつ	内容別
ないようぶつ	内容物
ないようなど	内容等
ないようてき	内容的
ないようせき	内容積
ないやあんだ	内野安打
ないめんてき	内面的
ないめんせい	内面性
ないむしょう	内務省
ないほうてき	内包的
ないぶんぴつ	内分泌
ないぶもでる	内部モデル
ないぶもーど	内部モード
ないぶひょう	内部表
ないぶひずみ	内部歪
ないぶどうさ	内部動作
ないぶそしき	内部組織
ないぶそうさ	内部操作
ないぶじかん	内部時間
ないぶしよう	内部仕様
ないぶしょり	内部処理
ないぶこーど	内部コード
ないぶきごう	内部記号
ないぶきこう	内部機構
ないぶかんさ	内部監査
ないぶかいろ	内部回路
ないふくやく	内服薬
ないふくえき	内服液
ないはいよう	内胚葉
ないないてい	内々定
ないてんほう	内点法
ないてんきん	内転筋
ないていしょ	内定書
ないていしゃ	内定者
ないていしき	内定式
ないつうしゃ	内通者
ないだいじん	内大臣
ないたいせつ	内体説
ないぞうよう	内蔵用
ないぞうがた	内蔵型
ないそうほう	内挿法
ないせんもう	内線網
ないせつえん	内接円
ないせいてき	内省的
ないしんのう	内親王
ないしんしょ	内申書
ないしんおう	内親王
ないしゃこう	内斜行
ないしのかみ	尚侍
ないしきょう	内視鏡
ないざいぶつ	内在物
ないざいてき	内在的
ないざいせい	内在性
ないこっかく	内骨格
ないこくさん	内国産
ないこくさい	内国債
ないこうてき	内向的
ないこうせい	内向性
ないげんけい	内原型
ないきんこん	内菌根
ないがいそう	内外装
ないかくせい	内閣制
ないうちゅう	内宇宙
ないいんせい	内因性
のりゆみのせち	賭弓の節
のりのみやさま	紀宮様
のりかえたんか	乗換単価
のりかえじかん	乗換時間
のりかえきゃく	乗換客
のむらそうけん	野村総研
のぼりちょうし	上り調子
のべつまくなし	のべつ幕無し
のとせんでんか	能登線電化
のじりほうえい	野尻抱影
のざわおんせん	野沢温泉
のさっぷみさき	納沙布岬
のがみでんてつ	野上電鉄
のうりんしょう	農林省
のうりょくてき	能力的
のうりょくしゃ	能力者
のうりょうさい	納涼祭
のうりゅうさん	濃硫酸
のうりつきゅう	能率給
のうはつうしん	脳波通信
のうにゅうしょ	納入書
のうどかいほう	農奴解放
のうたんがぞう	濃淡画像
のうそんしょう	脳損傷
のうそっちゅう	脳卒中
のうぜんかずら	凌霄花
のうぜいきげん	納税期限
のうすいしょう	農水省
のうじょうよう	嚢状葉
のうじょうさん	農場産
のうしょくけい	濃色系
のうしょうがい	脳障害
のうしゅっけつ	脳出血
のうしゅくよう	濃縮用
のうしゅくえき	濃縮液
のうしゃとうじ	納車当時
のうしゃきねん	納車記念
のうこうぶんか	農耕文化
のうこうかのう	農耕可能
のうげいかがく	農芸化学
のうけつりゅう	脳血流
のうぎょうよう	農業用
のうぎょうこく	農業国
のうきょうげん	能狂言
のうかすいたい	脳下垂体
のーべるしょう	ノーベル賞
ねんりょうぼう	燃料棒
ねんりょうてん	燃料店
ねんりょうだい	燃料代
ねんりょうけい	燃料計	燃料系
ねんりょうぎれ	燃料切れ
ねんりかんざん	年利換算
ねんまつねんし	年末年始
ねんぴせつやく	燃費節約
ねんぴじゅうし	燃費重視
ねんぴいちらん	燃費一覧
ねんないちゅう	年内中
ねんちょうしゃ	年長者
ねんちゃくせい	粘着性
ねんちゃくしつ	粘着質
ねんちゃくしき	粘着式
ねんちゃくざい	粘着剤	粘着材
ねんだいじゅん	年代順
ねんせいりょく	粘性力
ねんじそうかい	年次総会
ねんじけいかく	年次計画
ねんしょうとう	燃焼筒
ねんしょうそう	年少層
ねんしょうしつ	燃焼室
ねんしょうぐみ	年少組
ねんしほうそう	年始放送
ねんしきふめい	年式不明
ねんしきていど	年式程度
ねんげみしょう	拈華微笑
ねんきんせいど	年金制度
ねんきんききん	年金基金
ねんきぼうこう	年期奉公
ねんかんよやく	年間予約
ねんかんよさん	年間予算
ねんかんさいた	年間最多
ねやがわしゃこ	寝屋川車庫
ねぶくろじさん	寝袋持参
ねはばせいげん	値幅制限
ねつりょうけい	熱量計
ねつようりょう	熱容量
ねつぼうちょう	熱膨張
ねつぶつりがく	熱物理学
ねつせっしょく	熱接触
ねつじょうてき	熱情的
ねつしょりずみ	熱処理済
ねつこうかんぶ	熱交換部
ねつこうかんき	熱交換器
ねつあいちゅう	熱愛中
ねっとはんばい	ネット販売
ねったいやむけ	熱帯夜向
ねったいぎょや	熱帯魚屋
ねったいうりん	熱帯雨林
ねっしゃびょう	熱射病
ねっきょうてき	熱狂的
ねだんへんどう	値段変動
ねだんそうとう	値段相当
ねだんそうおう	値段相応
ねだんいじょう	値段以上
ねじりはちまき	捩じり鉢巻き	捩り鉢巻き
ねこかわいがり	猫かわいがり	猫可愛がり
にんむしっぱい	任務失敗
にんぽうちょう	忍法帳	忍法帖
にんべつちょう	人別帳
にんていせいど	認定制度
にんていしょう	認定証
にんていしぼう	認定死亡
にんちばいたい	認知媒体
にんちじっけん	認知実験
にんたいりょく	忍耐力
にんそくよせば	人足寄場
にんずうはあく	人数把握
にんずうこうか	人数効果
にんじょうぼん	人情本
にんじょうざた	刃傷沙汰
にんじゃぶたい	忍者部隊
にんしんちゅう	妊娠中
にんしんしょき	妊娠初期
にんしょうしき	認証式
にんしょうかん	認証官
にんしきりろん	認識理論
にんしきりょく	認識力
にんしきぶそく	認識不足
にんしきひょう	認識票
にんしきはんい	認識範囲
にんしきそうち	認識装置
にんしきせいど	認識精度
にんしきじしょ	認識辞書
にんしきじかん	認識時間
にんしきしょり	認識処理
にんしきしょく	認識色
にんしきけっか	認識結果
にんしききこう	認識機構
にんしきかてい	認識過程
にんしきかがく	認識科学
にんげんりかい	人間理解
にんげんもよう	人間模様
にんげんひとり	人間一人
にんげんばなれ	人間離れ
にんげんどらま	人間ドラマ
にんげんどっく	人間ドック
にんげんどうし	人間同士
にんげんそうさ	人間操作
にんげんじたい	人間自体
にんげんじしん	人間自身
にんげんしこう	人間志向
にんげんげんり	人間原理
にんげんぎらい	人間嫌い
にんげんきげき	人間喜劇
にんげんいがい	人間以外
にんげんあいて	人間相手
にんぎょうよう	人形用
にんぎょうてき	人形的
にんぎょうげき	人形劇
にんぎょうかん	人形館
にんきばんぐみ	人気番組
にんきばくはつ	人気爆発
にんきせんしゅ	人気選手
にんきせんこう	人気先行
にんきじょうい	人気上位
にんきしゃしゅ	人気車種
にんきさくひん	人気作品
にんかほうじん	認可法人
にんいだんたい	任意団体
にんいせいさん	任意清算
にんいかんすう	任意関数
にんいいんたい	任意引退
にわきょういく	庭教育
にるいるいしん	二塁塁審
にるいそうしゃ	二塁走者
にりんめんきょ	二輪免許
にりつはいはん	二律背反
にらやまちょう	韮山町
にょほうあんや	如法暗夜
にょうぼうやく	女房役
にょうどうえん	尿道炎
にょうしっきん	尿失禁
にょうさいかん	尿細管
にょうけっせき	尿結石
にゅうりょくま	入力待
にゅうりょくぶ	入力部
にゅうりょくち	入力値
にゅうりょくじ	入力時
にゅうりょくご	入力後
にゅうりょうび	入寮日
にゅうりょうひ	入寮費
にゅうよくざい	入浴剤
にゅうよくけん	入浴券
にゅうようしゅ	乳用種
にゅうもんよう	入門用
にゅうもんぼん	入門本
にゅうもんへん	入門編
にゅうもんばん	入門版
にゅうもんてき	入門的
にゅうもんてい	入門艇
にゅうもんしょ	入門書
にゅうもんしゃ	入門者
にゅうほうほう	入方法
にゅうぶとどけ	入部届
にゅうどうざき	入道崎
にゅうどうぐも	入道雲
にゅうとうぜい	入湯税
にゅうとうきん	乳頭筋
にゅうたいかい	入退会
にゅうせんけん	入船券
にゅうせいひん	乳製品
にゅうじょうじ	入場時
にゅうじょうご	入場後
にゅうしょしゃ	入所者
にゅうしょくち	入植地
にゅうしょうじ	乳小児
にゅうしゅもと	入手元
にゅうしゅほう	入手法
にゅうしゅなん	入手難
にゅうしゅっこ	入出庫
にゅうしゅずみ	入手済
にゅうしゅさき	入手先
にゅうしゃめん	入射面
にゅうしゃまえ	入社前
にゅうしゃそく	入射束
にゅうしゃしき	入社式
にゅうしゃこう	入射光
にゅうしゃかく	入射角
にゅうしゃおん	入射音
にゅうしせいど	入試制度
にゅうしかもく	入試科目
にゅうざいめん	乳剤面
にゅうざいそう	乳剤層
にゅうさんきん	乳酸菌
にゅうさつしゃ	入札者
にゅうさつしき	入札式
にゅうこくまえ	入国前
にゅうこくぜい	入国税
にゅうぎょけん	入漁権
にゅうきんがく	入金額
にゅうきょまえ	入居前
にゅうきょしゃ	入居者
にゅうがくせい	入学生
にゅうがくしゃ	入学者
にゅうがくしき	入学式
にゅうがくきん	入学金
にゅうかんけん	入館券
にゅうかりょう	入荷量
にゅうかいまえ	入会前
にゅうかいじき	入会時期
にゅうかいしゃ	入会者
にゅうかいきん	入会金
にゅうえんけん	入園券
にゅういんさき	入院先
にめんたいぐん	二面体群
にまいかんばん	二枚看板
にほんれっとう	日本列島
にほんりょこう	日本旅行
にほんりょうり	日本料理
にほんりくぐん	日本陸軍
にほんやちょう	日本野鳥
にほんやきゅう	日本野球
にほんみんよう	日本民謡
にほんほうもん	日本訪問
にほんぶんこう	日本分光	日本分校
にほんぶんがく	日本文学
にほんぶっさん	日本物産
にほんばんだい	日本版第
にほんはつばい	日本発売
にほんのりいれ	日本乗入
にほんのうえん	日本脳炎
にほんどくとく	日本独特
にほんとくゆう	日本特有
にほんとうちか	日本統治化
にほんでんとう	日本伝統
にほんでんそう	日本電装
にほんてつどう	日本鉄道
にほんていえん	日本庭園
にほんつううん	日本通運
にほんちんぼつ	日本沈没
にほんだいがく	日本大学
にほんたいざい	日本滞在
にほんたいかい	日本大会
にほんたいおう	日本対応
にほんぜんたい	日本全体
にほんぜんこく	日本全国
にほんせんしゅ	日本選手
にほんせめんと	日本セメント
にほんせきぐん	日本赤軍
にほんせいめい	日本生命
にほんせいふく	日本征服
にほんせいひん	日本製品
にほんせいさん	日本生産
にほんじんろん	日本人論
にほんじんみん	日本人民
にほんじんはつ	日本人初
にほんじんてき	日本人的
にほんじんごの	日本人好
にほんじんかん	日本人観
にほんじんかい	日本人会
にほんじょせい	日本女性
にほんしんぱん	日本信販
にほんしんどう	日本神道
にほんしんとう	日本新党
にほんしりーず	日本シリーズ
にほんしょえん	日本初演
にほんしゃかい	日本社会
にほんしどうぶ	日本指導部
にほんしじょう	日本市場	日本市上
にほんしぎょう	日本紙業
にほんさくひん	日本作品
にほんさいだい	日本最大
にほんさいしょ	日本最初
にほんさいこう	日本最高
にほんごりょく	日本語力
にほんごやくご	日本語訳語
にほんごぶぶん	日本語部分
にほんごふきか	日本語吹替
にほんごちゅう	日本語中
にほんごじまく	日本語字幕
にほんごじしょ	日本語辞書
にほんごしょり	日本語処理
にほんござっし	日本語雑誌
にほんごきのう	日本語機能
にほんごきげん	日本語起源
にほんごかんじ	日本語漢字
にほんごいがい	日本語以外
にほんこだいし	日本古代史
にほんこくみん	日本国民
にほんこくない	日本国内
にほんこくせき	日本国籍
にほんこくさい	日本国債
にほんこくがい	日本国外
にほんこうでん	日本光電
にほんこうだい	日本工大
にほんこうくう	日本航空
にほんこうかん	日本鋼管
にほんこうかい	日本公開
にほんこうえん	日本講演	日本公演
にほんけいざい	日本経済
にほんぐんじん	日本軍人
にほんぐんえい	日本軍営
にほんぎんこう	日本銀行
にほんきんかい	日本近海
にほんきぎょう	日本企業
にほんかいこう	日本海溝
にほんかいぐん	日本海軍
にほんかいがわ	日本海側
にほんおうふく	日本往復
にほんえんがん	日本沿岸
にほんいじょう	日本以上
にほんいしかい	日本医師会
にとものがたり	二都物語
にとべいなぞう	新渡戸稲造
にとうへいそう	二等兵曹
にとうぶんせん	二等分線
にてんさんてん	二転三転
にっぽんれーす	日本レース
にっぽんほんど	日本本土
にっぽんどうろ	日本道路
にっぽんでんき	日本電気
にっぽんぜおん	日本ゼオン
にっぽんじゅう	日本中
にっぽんけおり	日本毛織
にっぽんがいし	日本ガイシ	日本碍子
にっぽんかせい	日本化成
にっていひょう	日程表
にっていえんき	日程延期
にっちゅうかん	日中韓	日中間
にったいおうか	日体桜華
にっしんちょう	日進町
にっしんせいゆ	日清製油
にっしんげっぽ	日進月歩
にっしょうどう	日章堂
にっしょうけん	日照権
にっしゃりょう	日射量
にっしゃびょう	日射病
にっこうきどう	日光軌道
にっこういがい	日光以外
にっけんかがく	日研化学
にっけいひょう	日計表
にっけいにせい	日系二世
にっけいしょう	日経賞
にっきょうさい	日教済
にっきぶんがく	日記文学
にっかんけいば	日刊競馬
にっかどでんち	ニッカド電池
にちろせんそう	日露戦争
にちろせんえき	日露戦役
にちれんしゅう	日蓮宗
にちようびあさ	日曜日朝
にちようだいく	日曜大工
にちようしんや	日曜深夜
にちょうちょう	ニ長調
にちやどりょく	日夜努力
にちぼつじこく	日没時刻
にちべいひかく	日米比較
にちべいかいぎ	日米会議
にちどうかさい	日動火災
にちでんきょう	日電協
にちだいりこう	日大理工
にちだいぶざん	日大豊山
にちだいにこう	日大二高
にちじょうてき	日常的
にちじょうせい	日常性
にちじょうしゅ	日常酒
にちしゅくやす	日祝休
にちげつかすい	日月火水
にだんこうげき	二段攻撃
にだんかつよう	二段活用
にだんかいまえ	二段階前
にだいせいとう	二大政党
にたりよったり	似たり寄ったり
にたいもんだい	二体問題
にそくさんもん	二束三文
にせんえんさつ	二千円札
にせほんちょう	二瀬本町
にじょうじょう	二条城
にじゅっせいき	二十世紀
にじゅうろこう	二重露光
にじゅうろくや	二十六夜
にじゅうぼいん	二重母音
にじゅうひてい	2重否定
にじゅうにひき	二十二匹
にじゅうでんじ	二重電磁
にじゅうていぎ	二重定義
にじゅうしょう	二重唱
にじゅうかてい	二重過程
にじゅううつし	二重映し	二重写し
にじゅういっし	二十一史
にじはいふしゃ	二次配布者
にじせいちょう	二次生長
にじすいしょう	虹水晶
にじしょうがい	二次障害
にじきょくめん	 2 次曲面	２次曲面
にじきょくせん	二次曲線
にじかんみゃく	二次間脈
にじいかんそく	二次維管束
にしゅうかんご	二週間後
にしゃたくいつ	二者択一
にしゃせんいつ	二者選一
にしまごめかん	西馬込間
にしふじのみや	西富士宮
にしひろしまし	西広島市
にしはんきゅう	西半球
にしのみやせん	西宮線
にしのみやかん	西宮間
にしにほんへん	西日本編
にしにほんしぶ	西日本支部
にしにほんごか	西日本語化
にしにほんけん	西日本圏
にしにほんがわ	西日本側
にしにほんいち	西日本一
にしとうきょう	西東京
にしてつろせん	西鉄路線
にしだとしゆき	西田敏行
にしだきたろう	西田幾多郎
にししんじゅく	西新宿
にししらいかん	西白井間
にしこくぶんじ	西国分寺
にしくわなえき	西桑名駅
にしきょうごく	西京極
にしきのみはた	錦の御旗
にしかわきよし	西川きよし
にしかるいざわ	西軽井沢
にしおおつえき	西大津駅
にしおおいえき	西大井駅
にしあらいかん	西新井間
にさんかちっそ	二酸化窒素
にさんかたんそ	二酸化炭素
にさんかいおう	二酸化硫黄
にこうかんけい	2項関係	二項関係
にげこうじょう	逃げ口上
にくようぎゅう	肉用牛
にくすいかじょ	肉穂花序
にくしょくせい	肉食性
にくしょくぎょ	肉食魚
にくがんせいず	肉眼星図
にぎょうめいか	二行目以下
にがびゃくどう	二河白道
にがつかくめい	二月革命
にかいめいこう	二回目以降
にかいこうかん	二回交換
にいがたちいき	新潟地域
にいがたしない	新潟市内
にあぴんしょう	ニアピン賞
なんりゅうせき	南流石
なんもんしゅう	難問集
なんぼんばしら	何本柱
なんぼくりゅう	南北流
なんぼくちょう	南北朝
なんべいびょう	南米病
なんぶはくじん	南部白人
なんぶてつびん	南部鉄瓶
なんぴょうよう	南氷洋
なんびょうかん	何秒間
なんびゃくまん	何百万
なんびゃくねん	何百年
なんびゃくにん	何百人
なんびゃくつう	何百通
なんびゃくえん	何百円
なんにちぐらい	何日位
なんどくちめい	難読地名
なんとほくれい	南都北嶺
なんとうきゅう	何等級
なんちょうしゃ	難聴者
なんちゃくりく	軟着陸
なんちしっかん	難治疾患
なんせんほくば	南船北馬
なんせいにほん	南西日本
なんせいげかん	軟性下疳
なんじゅっぽん	何十本
なんじゅっぷん	何十分
なんじゅっぴき	何十匹
なんじゅってん	何十点
なんじゅっつう	何十通
なんじゅっけん	何十軒	何十件
なんじゅっかい	何十回
なんじゅうもん	何十問
なんじゅうまん	何十万
なんじゅうばい	何十倍
なんじゅうねん	何十年
なんじゅうにん	何十人
なんじゅうだい	何十台
なんじゅうえん	何十円
なんじゃくもの	軟弱者
なんじなんぷん	何時何分
なんしゅうねん	何周年
なんしゅうかん	何週間
なんこうふらく	難攻不落
なんきんせんし	南京戦史
なんきんじょう	南京錠
なんきんじけん	南京事件
なんきょくてん	南極点
なんきょくけん	南極圏
なんきょくかい	南極海
なんきしらはま	南紀白浜
なんかいりゅう	南海龍
なんかいじしん	南海地震
なるとおおはし	鳴門大橋
なりたほうめん	成田方面
なりたしんぽう	成田新法
なりたくうこう	成田空港
なりきんしゅみ	成金趣味
ならじょしだい	奈良女子大
ならけんなんぶ	奈良県南部
なよろほんせん	名寄本線
なむあみだぶつ	南無阿弥陀仏
なみひととおり	並一通り
なみきおおはし	並木大橋
なまびょうほう	生兵法
なまちゅうけい	生中継
なましゅつえん	生出演
なまぐさぼうず	生臭坊主
なまえんそうか	生演奏家
なまえようもじ	名前用文字
なまえくうかん	名前空間
なまいきざかり	生意気盛り
なべやきうどん	鍋焼き饂飩
なのかしゅうき	七日週期
なにはさておき	何は扨置き	何は扨措き
ななれんしょう	七連勝
ななめぜんぽう	斜前方
ななめこうほう	斜後方
ななころびやお	七転び八起
なつめそうせき	夏目漱石
なつがっしゅく	夏合宿
なっとくいただ	納得頂
なっとうしゅう	納豆臭
なだちゅうがく	灘中学
なだきたどおり	灘北通
なだいやくしゃ	名題役者
なすこうじょう	那須工場
なごやめいぶつ	名古屋名物
なごやほんせん	名古屋本線
なごやほうめん	名古屋方面
なごやてつどう	名古屋鉄道
なごやだいがく	名古屋大学
なごやだいいん	名古屋大院
なごやたいかい	名古屋大会
なごやこうだい	名古屋工大
なごやこうそく	名古屋高速
なごやこうえん	名古屋公演
なごやこーちん	名古屋コーチン
なごやけいえい	名古屋経営
なごやくうこう	名古屋空港
なごやきんこう	名古屋近郊
なごやえきまえ	名古屋駅前
なごやえきちか	名古屋駅地下
ながれさぎょう	流作業
ながぶちつよし	長渕剛	長淵剛
ながのほうめん	長野方面
ながのでんてつ	長野電鉄
ながのだいがく	長野大学
ながのしぎかい	長野市議会
ながのこうせん	長野高専
ながのけんみん	長野県民
ながてほうこう	長手方向
ながしましげお	長嶋茂雄
ながさきでんき	長崎電軌
ながさきしない	長崎市内
ながおかぎだい	長岡技大
ながおかきょう	長岡京
ながいこうえん	長居公園
なかよしこよし	仲良し小好し
なかやまりょう	中山陵
なかやまひんば	中山牝馬
なかやまとうげ	中山峠
なかやまきねん	中山記念
なかもりあきな	中森明菜
なかめぐろがわ	中目黒側
なかむらたかし	中村尚司
なかのむさしの	中野武蔵野
なかのほうめん	中野方面
なかのしょてん	中野書店
なかじまふとう	中島埠頭
なかじまあつし	中島敦
なかしべつかん	中標津間
なかがみけんじ	中上健次
なかかるいざわ	中軽井沢
なかおかちまち	仲御徒町
ないりんいがい	内輪以外
ないようりょう	内容量
ないようほうふ	内容豊富
ないようふめい	内容不明
ないようどおり	内容通り
ないようちゅう	内容中
ないようじたい	内容自体
ないようしだい	内容次第
ないようごかん	内容互換
ないようぎんみ	内容吟味
ないよういぜん	内容以前
ないむだいじん	内務大臣
ないほうろんり	内包論理
ないぶりゅうほ	内部留保
ないぶもんだい	内部問題
ないぶむじゅん	内部矛盾
ないぶほうかい	内部崩壊
ないぶへんすう	内部変数
ないぶぶんれつ	内部分裂
ないぶひょうか	内部評価
ないぶてきおう	内部適応
ないぶていこう	内部抵抗
ないぶだんせん	内部断線
ないぶぞうせつ	内部増設
ないぶせってい	内部設定
ないぶじゆうど	内部自由度
ないぶじつげん	内部実現
ないぶじじょう	内部事情
ないぶしりょう	内部資料
ないぶこくはつ	内部告発
ないぶこうぞう	内部構造
ないぶこうせい	内部構成
ないぶけつごう	内部結合
ないぶけいしき	内部形式
ないぶかんすう	内部関数
ないぶうちゅう	内部宇宙
ないねんきかん	内燃機関
ないぞうはれつ	内臓破裂
ないぞうどけい	内蔵時計
ないぞうとけい	内蔵時計
ないぞうでんち	内蔵電池
ないぞうこてい	内蔵固定
ないぞうかんじ	内蔵漢字
ないぞうかのう	内蔵可能
ないせんひょう	内線表
ないせんでんわ	内線電話
ないせんじょう	内線上
ないせいぶんし	内生分枝
ないせいじょう	内清浄
ないじょのこう	内助の功
ないじゅどころ	内豎所
ないじしんけい	内耳神経
ないしょばなし	内緒話
ないしゅっけつ	内出血
ないしゅうげん	内祝言
ないこくさんば	内国産馬
ないこうしょう	内交渉
ないかくぶんこ	内閣文庫
ないかくこくじ	内閣告示
ないかいこうろ	内海航路
のんれむすいみん	ノンレム睡眠
のりつぎわりびき	乗継割引
のりくらこうげん	乗鞍高原
のりくらおんせん	乗鞍温泉
のりかえそんしつ	乗換損失
のりかえあんない	乗換案内
のむらしょうけん	野村證券	野村証券
のべにんこうすう	延人工数
のざきさんぎょう	野崎産業
のうりんだいじん	農林大臣
のうりんすいさん	農林水産
のうりょくぶそく	能力不足
のうりょくじょう	能力上
のうりょくじたい	能力自体
のうりょくしょく	濃緑色
のうりょくしゅぎ	能力主義
のうりょくしだい	能力次第
のうりょくきゅう	能力給
のうりつかいぜん	能率改善
のうやくせいぶん	農薬成分
のうやくくうさん	農薬空散
のうふせいきゅう	納付請求
のうにゅうきげん	納入期限
のうにゅうきかん	納入期間
のうなんかしょう	脳軟化症
のうないしんけい	脳内神経
のうどうせいぎょ	能動制御
のうどうきつえん	能動喫煙
のうだいいちこう	農大一高
のうそんふうけい	農村風景
のうぜいしんこく	納税申告
のうぜいぎむしゃ	納税義務者
のうぜいかんけい	納税関係
のうしゅくうらん	濃縮ウラン
のうしじょうたい	脳死状態
のうこうだいがく	農工大学
のうこうしりょう	濃厚飼料
のうこうしゃかい	農耕社会
のうぎょうようち	農業用地
のうかくこうぞう	能格構造
ねんれいふしょう	年齢不詳
ねんれいそうおう	年齢相応
ねんれいせってい	年齢設定
ねんれいせいべつ	年齢性別
ねんれいせいげん	年齢制限	年令制限
ねんれいこうせい	年齢構成
ねんれいげんてい	年齢限定
ねんりょうゆそう	燃料輸送
ねんりょうぶそく	燃料不足
ねんりょうでんち	燃料電池
ねんりょうたんく	燃料タンク
ねんりょうそうち	燃料装置
ねんまつほうどう	年末報道
ねんまつばんぐみ	年末番組
ねんまつどうよう	年末同様
ねんぴこうじょう	燃費向上
ねんねんさいさい	年々歳々	年年歳歳
ねんないはつばい	年内発売
ねんちゃくりょく	粘着力
ねんちゃくぶぶん	粘着部分
ねんだいとくてい	年代特定
ねんだいぜんはん	年代前半
ねんだいこうはん	年代後半
ねんすうせんえん	年数千円
ねんしょうそくど	燃焼速度
ねんしょうじかん	燃焼時間
ねんしょうしけん	燃焼試験
ねんしょうおんど	燃焼温度
ねんしゅうにゅう	年収入
ねんしきそうおう	年式相応
ねんこうちんぎん	年功賃金
ねんこうじょれつ	年功序列
ねんきんぶんかつ	年金分割
ねんきんせいかつ	年金生活
ねんがじょうよう	年賀状用
ねんかんほうそう	年間放送
ねんかんへいきん	年間平均
ねんかんとうろく	年間登録
ねんかんこうどく	年間購読
ねんえきすいしゅ	粘液水腫
ねんえきさいぼう	粘液細胞
ねつりきがくてき	熱力学的
ねつりきがくけい	熱力学系
ねつでんどうろん	熱伝導論
ねつでんどうりつ	熱伝導率
ねつでんどうせい	熱伝導性
ねつでんたつりつ	熱伝達率
ねつてんしゃしき	熱転写式
ねつちゅうせいし	熱中性子
ねつこうかんがた	熱交換型
ねつきょうきゅう	熱供給
ねっちゅうしょう	熱中症
ねったいぎょよう	熱帯魚用
ねっかんあつえん	熱間圧延
ねだんこうしょう	値段交渉
ぬまずこうじょう	沼津工場
ぬきあしさしあし	抜き足差し足
ぬかたのおおきみ	額田王
にんめいほうしき	任命方式
にんとくてんのう	仁徳天皇
にんてんどうせい	任天堂製
にんていようけん	認定要件
にんていほうほう	認定方法
にんていばんごう	認定番号
にんていきじゅん	認定基準
にんちのうりょく	認知能力
にんちてききのう	認知的機能
にんちしんりがく	認知心理学
にんちかがっかい	認知科学会
にんちかがくてき	認知科学的
にんちかがくしゃ	認知科学者
にんちかがくしつ	認知科学室
にんちかがくかい	認知科学会
にんずうせいげん	人数制限
にんずうこうせい	人数構成
にんじょうばなし	人情噺	人情話
にんじょうきげき	人情喜劇
にんしょうきこう	認証機構
にんしきもじれつ	認識文字列
にんしきほうほう	認識方法
にんしきせいのう	認識性能
にんしきじっけん	認識実験
にんしきしゅたい	認識主体
にんしきさんぷる	認識サンプル
にんしきこうぞう	認識構造
にんしきかがくか	認識科学科
にんさんばけしち	人三化七
にんこうてんのう	仁孝天皇
にんげんふうしゃ	人間風車
にんげんばくだん	人間爆弾
にんげんとくゆう	人間特有
にんげんだいがく	人間大学
にんげんそんざい	人間存在
にんげんせいてき	人間性的
にんげんしゃかい	人間社会
にんげんしっかく	人間失格
にんげんこくほう	人間国宝
にんげんこうがく	人間工学
にんげんけいたい	人間形態
にんげんがくるい	人間学類
にんげんかんけい	人間関係
にんけんてんのう	仁賢天皇
にんぎょうとうげ	人形峠
にんぎょうつかい	人形遣い
にんぎょうちょう	人形町
にんぎょうさっか	人形作家
にんぎょうあそび	人形遊び
にんきまんりょう	任期満了
にんきとうひょう	人気投票
にんきぜっちょう	人気絶頂
にんきしょうひん	人気商品
にんききゅうだん	人気球団
にんきうすどうし	人気薄同士
にんいしゅっとう	任意出頭
にんいきょくめん	任意曲面
にるいそうきゅう	二塁送球
にりんじどうしゃ	二輪自動車
にりんきょうしつ	二輪教室
にょにんきんぜい	女人禁制
にょうろけっせき	尿路結石
にょうぼうことば	女房詞
にょうほうしょう	尿崩症
にょうどくしょう	尿毒症
にゅうりょくわく	入力枠
にゅうりょくれつ	入力列
にゅうりょくれい	入力例
にゅうりょくよう	入力用
にゅうりょくもじ	入力文字
にゅうりょくめん	入力面
にゅうりょくみす	入力ミス
にゅうりょくほう	入力法
にゅうりょくぶん	入力文
にゅうりょくてき	入力的
にゅうりょくだん	入力段
にゅうりょくそう	入力相	入力層
にゅうりょくせん	入力線
にゅうりょくしゃ	入力者
にゅうりょくしき	入力式
にゅうりょくがわ	入力側
にゅうりょくおん	入力音
にゅうりょくいち	入力位置
にゅうりょくいき	入力域
にゅうよくりょう	入浴料
にゅうよくちゅう	入浴中
にゅうよくきんし	入浴禁止
にゅうようぎゅう	乳用牛
にゅうもんこうざ	入門講座
にゅうふこんいん	入夫婚姻
にゅうはくしょく	乳白色
にゅうとうとっき	乳頭突起
にゅうだんてすと	入団テスト
にゅうだんきょひ	入団拒否
にゅうだんきぼう	入団希望
にゅうたいじょう	入退場
にゅうたいしゅつ	入退出
にゅうせんじかん	入線時間
にゅうせきとどけ	入籍届
にゅうじょうりつ	入場率
にゅうじょうまえ	入場前
にゅうじょうぜい	入場税
にゅうじょうしゃ	入場者
にゅうじょうしき	入場式
にゅうじょうけん	入場券
にゅうじょうぐち	入場口
にゅうじとっぱつ	乳児突発
にゅうしょくしゃ	入植者
にゅうしょうりつ	入賞率
にゅうしょうしゃ	入賞者
にゅうしゅふのう	入手不能
にゅうしゅばしょ	入手場所
にゅうしゅつこく	入出国
にゅうしゅちゅう	入手中
にゅうしゅじゅん	入手順
にゅうしゅけいろ	入手経路
にゅうしゅかのう	入手可能
にゅうしゅかてい	入手過程
にゅうしゅいこう	入手以降
にゅうしゃねんど	入社年度
にゅうしゃしけん	入社試験
にゅうしゃいらい	入社以来
にゅうしもんだい	入試問題
にゅうさつかかく	入札価格
にゅうこくちてん	入国地点
にゅうこくしんさ	入国審査
にゅうこくきょひ	入国拒否
にゅうこうりょう	入港料
にゅうぎょりょう	入漁料
にゅうきんひょう	入金票
にゅうきょしかく	入居資格
にゅうがくりょう	入学料
にゅうがくねんど	入学年度
にゅうがくとうじ	入学当時
にゅうがくしけん	入学試験
にゅうかんりょう	入館料
にゅうかんきょく	入感局
にゅうかだいすう	入荷台数
にゅうかいしかく	入会資格
にゅうかいきぼう	入会希望
にゅうかいかのう	入会可能
にゅうえんりょう	入園料
にゅういんりょう	乳飲料
にゅういんちゅう	入院中
にゅういんきかん	入院期間
にゅーすばんぐみ	ニュース番組
にゅーじーらんど	新西蘭
にもつはんにゅう	荷物搬入
にもつしゃりょう	荷物車両
にほんりょうりや	日本料理屋
にほんみはつばい	日本未発売
にほんみこうかい	日本未公開
にほんぶんかてき	日本文化的
にほんぶんかしゃ	日本文華社
にほんぶどうかん	日本武道館
にほんぶっきょう	日本仏教
にほんばんじまく	日本版字幕
にほんはっちゃく	日本発着
にほんでんさんき	日本電算機
にほんでんきせい	日本電気製
にほんていちゃく	日本定着
にほんだいりてん	日本代理店
にほんだいひょう	日本代表
にほんたいしかん	日本大使館
にほんじんふうふ	日本人夫婦
にほんじんばぬし	日本人馬主
にほんじんどうし	日本人同士
にほんじんだんぎ	日本人談義
にほんじんしよう	日本人仕様
にほんじんさっか	日本人作家
にほんじんきしゃ	日本人記者
にほんじんいみん	日本人移民
にほんじんいぞく	日本人遺族
にほんじんいがい	日本人以外
にほんじょうだん	日本冗談
にほんじょうくう	日本上空
にほんじゅうだん	日本縦断
にほんしんきろく	日本新記録
にほんしょくひん	日本食品
にほんしょくてん	日本食店
にほんしゅっぱん	日本出版
にほんしゅっぱつ	日本出発
にほんしゃりょう	日本車両
にほんしたんほう	日本史探訪
にほんしかんけい	日本史関係
にほんごもじれつ	日本語文字列
にほんごほんらい	日本語本来
にほんごほんやく	日本語翻訳
にほんごほうそう	日本語放送
にほんごへんかん	日本語変換
にほんごぶんぽう	日本語文法
にほんごぶんしょ	日本語文書
にほんごぶんけん	日本語文献
にほんごひょうじ	日本語表示
にほんごひょうき	日本語表記
にほんごばんよう	日本語版用
にほんごどくとく	日本語独特
にほんごたんまつ	日本語端末
にほんごたいおう	日本語対応
にほんごせんよう	日本語専用
にほんごしょるい	日本語書類
にほんごくどうし	日本極道史
にほんごかんれん	日本語関連
にほんごかんけい	日本語関係
にほんごかいせき	日本語解析
にほんごおんいん	日本語音韻
にほんごいじょう	日本語以上
にほんこくせいふ	日本国政府
にほんこうぎょう	日本鉱業
にほんがわふたん	日本側負担
にほんがくしいん	日本学士院
にほんかがっかい	日本化学会
にほんえんげきし	日本演劇史
にほんいっしゅう	日本一周
にほんいたがらす	日本板硝子
にぶじょうじょう	二部上場
にひょうめいこう	二票目以降
にのみやぶんいん	二宮分院
にのみやそんとく	二宮尊徳
ににんさんきゃく	二人三脚
にっぽんれっとう	日本列島
にっぽんゆそうき	日本輸送機
にっぽんゆうせん	日本郵船
にっぽんほうそう	ニッポン放送	日本放送
にっぽんぺいんと	日本ペイント
にっぽんびくたー	日本ビクター
にっぽんとむそん	日本トムソン
にっぽんでんつう	日本電通
にっぽんでんそう	日本電装
にっぽんでんこう	日本電工
にっぽんつううん	日本通運
にっぽんたいかい	日本大会
にっぽんせいふん	日本製粉
にっぽんせいこう	日本精工
にっぽんすいさん	日本水産
にっぽんしんやく	日本新薬
にっぽんしんぱん	日本信販
にっぽんこうくう	日本航空
にっぽんこうかん	日本鋼管
にっぽんけみふぁ	日本ケミファ
にっぽんけみこん	日本ケミコン
にっぽんけいざい	日本経済
にっぽんぐんじん	日本軍人
にっぽんぎんこう	日本銀行
にっぽんきんぞく	日本金属
にっぽんかーぼん	日本カーボン
にっぽうほんせん	日豊本線
にっとうぼうせき	日東紡績
にっとうせいもう	日東製網
にっとうしょいん	日東書院
にっていみつもり	日程見積り
にっていへんこう	日程変更
にっつうこうくう	日通航空
にっちゅうしよう	日中使用
にっしんぼうせき	日清紡績
にっしんせんそう	日清戦争
にっしんせいふん	日清製粉
にっしんせいこう	日新製鋼
にっしょうりょう	日照量
にっしょうぶそく	日照不足
にっしょうじかん	日照時間
にっしょういわい	日商岩井
にっさんよこはま	日産横浜
にっさんしゃたい	日産車体
にっさんうんそう	日産運送
にっこうほんせん	日光本線
にっけいへいきん	日経平均
にっけいしんぶん	日経新聞
にっけいきぎょう	日系企業
にっかんやきゅう	日韓野球
にちろぎょぎょう	日魯漁業
にちようさいじつ	日曜祭日
にちようがっこう	日曜学校
にちほうほんせん	日豊本線
にちべいやきゅう	日米野球
にちべいたいこう	日米対抗
にちべいせんそう	日米戦争
にちべいしんぜん	日米親善
にちべいかかくさ	日米価格差
にちべいかいせん	日米開戦
にちなんがくえん	日南学園
にちなんかいがん	日南海岸
にちだいやまがた	日大山形
にちだいこうどう	日大講堂
にちじょたいだい	日女体大
にちじょうりよう	日常利用
にちじょうちしき	日常知識
にちじょうさはん	日常茶飯
にちじょうげんご	日常言語
にちじょうかいわ	日常会話
にちぎんたんかん	日銀短観
にちぎんそうさい	日銀総裁
にちかもくきんど	日火木金土
にだいしょうぐん	二代将軍
にだいかいちょう	二代会長
にじょうてんのう	二条天皇
にじゅうよんきん	二十四金
にじゅうめんそう	二十面相
にじゅうばしまえ	二重橋前
にじゅうはんてん	二重反転
にじゅうとうろく	二重登録
にじゅうとうこう	二重投稿
にじゅうたいけい	二重体系
にじゅうせきぶん	二重積分
にじゅうすうせき	二十数隻
にじゅうじんかく	二重人格
にじゅうしせっき	二十四節気
にじゅうこくせき	二重国籍
にじゅうこうぞう	二重構造
にじゅうきじゅん	二重基準
にじゅうかんせつ	二重間接
にじゅうかくさん	二重拡散
にじゅうおんせい	二重音声
にじゅういっぴき	二十一匹
にじほうていしき	二次方程式
にじしようりょう	二次使用料
にじきおくそうち	二次記憶装置
にじおくれようそ	二次遅れ要素
にしんひょうげん	二進表現
にしょうがくしゃ	二松学舎
にしゅうれんぞく	二週連続
にしゅうめいこう	二周目以降
にしゅうかんまえ	二週間前
にしもとかんとく	西本監督
にしふなばしかん	西船橋間
にしふなばしえき	西船橋駅
にしのみやいとう	西宮以東
にしのみやいせい	西宮以西
にしにほんししゃ	西日本支社
にしにほんくかん	西日本区間
にしにほんいせい	西日本以西
にしとじょうかん	西都城間
にしてつふくおか	西鉄福岡
にしたかしまだい	西高島台
にしすずらんだい	西鈴蘭台
にしぐちちかがい	西口地下街
にしくじょうかん	西九条間
にしきりゅうえき	西桐生駅
にしきょうとえき	西京都駅
にしがわぜんたい	西側全体
にしがわじんえい	西側陣営
にしがわしょこく	西側諸国
にしかごしまかん	西鹿児島間
にしかいがんとし	西海岸都市
にしおぎくぼえき	西荻窪駅
にしおかざきかん	西岡崎間
にしおおさかせん	西大阪線
にしいちさんるい	二死一三塁
にしいずほうめん	西伊豆方面
にこうえんざんし	二項演算子
にくたいろうどう	肉体労働
にくたいねんれい	肉体年齢
にくたいてきさい	肉体的差異
にくたいかんけい	肉体関係
にくじきさいたい	肉食妻帯
にかいさんじゅつ	二階算術
にいがためいくん	新潟明訓
にいがたみつこし	新潟三越
にいがたほうそう	新潟放送
にいがただいがく	新潟大学
にいがたこうつう	新潟交通
にいかっぷちょう	新冠町
にいいかかくてい	二位以下確定
にありーいこーる	≒
なんもんそくとう	難問即答
なんみんきゃんぷ	難民キャンプ
なんみんえんじょ	難民援助
なんぼくもんだい	南北問題
なんぼくせんそう	南北戦争
なんぼくせいぶん	南北成分
なんべいりょこう	南米旅行
なんべいほうめん	南米方面
なんべいおうふく	南米往復
なんびょういない	何秒以内
なんびゃくぎょう	何百行
なんねんなんくみ	何年何組
なんねんなんがつ	何年何月
なんちゅうじこく	南中時刻
なんたいどうぶつ	軟体動物
なんぜんまんにん	何千万人
なんぜんまんえん	何千万円
なんせいほうこう	南西方向
なんせいしょとう	南西諸島
なんせいこうくう	南西航空
なんじゅうりょう	何十両
なんじゅうばしん	何十馬身
なんじゅうおくこ	何十億個
なんしきやきゅう	軟式野球
なんざんだいがく	南山大学
なんきんかんらく	南京陥落
なんがつなんにち	何月何日
なんかいほんせん	南海本線
なんかいほうそう	南海放送
なんかいでんてつ	南海電鉄
なんかいでんしゃ	南海電車
なんかいおうこく	南海王国
なんいどせってい	難易度設定
なるさわりんどう	鳴沢林道
なりひらばしえき	業平橋駅
ならやまぶしこう	楢山節考
ならせんたんだい	奈良先端大
ならせんえんせん	奈良線沿線
ならずものこっか	ならず者国家
なまりかごうぶつ	鉛化合物
なまごみしょりき	生ごみ処理機
なまこんくりーと	生コンクリート
なまえつきぱいぷ	名前付きパイプ
ななほしてんとう	七星瓢虫
ななしゅきょうぎ	七種競技
ななころびやおき	七転び八起き
なないろかいいき	七色海域
なでしこもくぐん	ナデシコ目群
なだれげんしょう	雪崩現象
なごやきんこぐん	名古屋金鯱軍
なきりぼうちょう	菜切包丁	菜切り包丁
ながのこうじょう	長野工場
ながせさんぎょう	長瀬産業
ながしまかんとく	長嶋監督
ながしまかずしげ	長島一茂
ながしまおんせん	長島温泉
ながさきほんせん	長崎本線
ながさきへんせい	長崎編成
ながさきにちだい	長崎日大
ながさきでんてつ	長崎電鉄
ながさきだいがく	長崎大学
ながさきしんぶん	長崎新聞
ながさきけんえい	長崎県営
ながさきくうこう	長崎空港
ながさきかんこう	長崎観光
ながさきえきまえ	長崎駅前
ながおかてんじん	長岡天神
ながおかぎかだい	長岡技科大
ながおかきょうし	長岡京市
ながえさんきょう	長江三峡
なかわきべつえき	中湧別駅
なかめぐろてまえ	中目黒手前
なかむらこうこう	中村高校
なかはらちゅうや	中原中也
なかはらかいどう	中原街道
なかはらかいかん	中原会館
なかのぶがくえん	中延学園
なかのさんぷらざ	中野サンプラザ
なかつかさしょう	中務省
なかそねやすひろ	中曽根康弘
なかじまつねゆき	中島常幸
なかえちょうみん	中江兆民
ないようへんこう	内容変更
ないようぶんるい	内容分類
ないようぶんせき	内容分析
ないようせつめい	内容説明
ないようこうがい	内容梗概
ないようこうかい	内容公開
ないようかくにん	内容確認
ないよういちらん	内容一覧
ないゆうがいかん	内憂外患
ないやじゆうせき	内野自由席
ないぶんぴつけい	内分泌系
ないぶりょういき	内部領域
ないぶふせいごう	内部不整合
ないぶひょうげん	内部表現
ないぶてききのう	内部的機能
ないぶそうしょく	内部装飾
ないぶじょうほう	内部情報
ないぶじょうたい	内部状態
ないぶしょうがい	内部障害
ないぶこうりょく	内部抗力
ないぞうほうしき	内蔵方式
ないぞうしっかん	内臓疾患
ないぞうかんかく	内臓感覚
ないぞうおんげん	内蔵音源
ないせんばんごう	内線番号
ないせいもんだい	内政問題
ないせいほうこく	内省報告
ないじゅかくだい	内需拡大
ないしんふくざつ	内心複雑
ないしゅうちょう	内周長
ないさいぼうかい	内細胞塊
ないこくかいしゃ	内国会社
ないきじゅんかん	内気循環
ないがいかかくさ	内外価格差
ないかくくんれい	内閣訓令
ないかくかんぼう	内閣官房
のりつぎしていえき	乗継指定駅
のりくみいんすがた	乗組員姿
のりいれきゅうこう	乗入急行
のだせんこうじせん	野田専光寺線
のうりょくひょうか	能力評価
のうりょくいっぱい	能力一杯
のうにゅうじっせき	納入実績
のうないしゅっけつ	脳内出血
のうぜいつうちしょ	納税通知書
のうぜいしょうめい	納税証明
のうぜいかんりにん	納税管理人
のうしゅくかんげん	濃縮還元
のうぎょうようすい	農業用水
のうぎょうせいさく	農業政策
のうぎょうしょとく	農業所得
のうかんしょうがい	脳幹障害
ねんりょうほきゅう	燃料補給
ねんりょうふんしゃ	燃料噴射
ねんりょうさいくる	燃料サイクル
ねんまつちょうせい	年末調整
ねんまつしょうせん	年末商戦
ねんまつさいしゅう	年末最終
ねんどだいひょうば	年度代表馬
ねんちゅうぎょうじ	年中行事
ねんちゃくけいすう	粘着係数
ねんじゅうむきゅう	年中無休
ねんしょうこうりつ	燃焼効率
ねんしょうけいさん	燃焼計算
ねんしきゅうぎょう	年始休業
ねんがらねんじゅう	年がら年中
ねんかんよやくせき	年間予約席
ねんかんしょうきん	年間賞金
ねんかんしぼうすう	年間死亡数
ねんかんしていせき	年間指定席
ねんかいひむりょう	年会費無料
ねむりきょうしろう	眠狂四郎
ねつえんじゅんかん	熱塩循環
ねっちゅうせんげん	熱中宣言
ねったいていきあつ	熱帯低気圧
ねったいぎょしいく	熱帯魚飼育
ねぎしけいばじょう	根岸競馬場
ぬのせいとざんぐつ	布製登山靴
にんむじょうきょう	任務状況
にんみょうてんのう	仁明天皇
にんていこうじょう	認定工場
にんちてきかつどう	認知的活動
にんだくちょうしょ	認諾調書
にんしんてきれいき	妊娠適齢期
にんしんちゅうぜつ	妊娠中絶
にんしんしゅっさん	妊娠出産
にんしきのうりょく	認識能力
にんしきたいしょう	認識対象
にんげんじょうほう	人間情報
にんげんげきじょう	人間劇場
にんげんかんきょう	人間環境
にんぎょうげきだん	人形劇団
にんぎょうかいぞう	人形改造
にんきじょうしょう	人気上昇
にんいじゅんびきん	任意準備金
にょうどうけっせき	尿道結石
にゅうりょくようそ	入力要素
にゅうりょくはけい	入力波形
にゅうりょくちゅう	入力中
にゅうりょくたんし	入力端子
にゅうりょくそくど	入力速度
にゅうりょくそうち	入力装置
にゅうりょくじげん	入力次元
にゅうりょくしょり	入力処理
にゅうりょくぎょう	入力行
にゅうりょくきろく	入力記録
にゅうりょくきのう	入力機能
にゅうりょくかんじ	入力漢字
にゅうりょくかのう	入力可能
にゅうもんしゃよう	入門者用
にゅうもんかいせつ	入門解説
にゅうとうおんせん	乳頭温泉
にゅうだんすんぜん	入団寸前
にゅうたいじょうじ	入退場時
にゅうじょうりょう	入場料
にゅうじょうきんし	入場禁止
にゅうじょうきょく	入場曲
にゅうしょきじゅん	入所基準
にゅうしゅほうほう	入手方法
にゅうしゅふかのう	入手不可能
にゅうしゅつりょく	入出力
にゅうしゅつこくじ	入出国時
にゅうしゅっこくじ	入出国時
にゅうしゅしゅだん	入手手段
にゅうしゅこんなん	入手困難
にゅうしゃりゅうし	入射粒子
にゅうしゃあんない	入社案内
にゅうざいばんごう	乳剤番号
にゅうさんはっこう	乳酸発酵
にゅうさつほうしき	入札方式
にゅうさつきんがく	入札金額
にゅうこくさしょう	入国査証
にゅうがくていいん	入学定員
にゅうかいほうほう	入会方法
にゅうかいとくてん	入会特典
にゅうかいてつづき	入会手続き
にゅうかいたいかい	入会退会
にゅうかいごきぼう	入会御希望
にゅうかいかんゆう	入会勧誘
にゅうかいあんない	入会案内
にゅうえんむりょう	入園無料
にゅういんちりょう	入院治療
にゅういんせいかつ	入院生活
にゅういんかんじゃ	入院患者
にもつうんぱんよう	荷物運搬用
にほんりょうりかい	日本料理界
にほんりょうじかん	日本領事館
にほんむかしばなし	日本昔話
にほんぶんげいしゃ	日本文芸社
にほんばしみつこし	日本橋三越
にほんばしまるぜん	日本橋丸善
にほんばしほんてん	日本橋本店
にほんていこくぐん	日本帝国軍
にほんだいひょうば	日本代表馬
にほんせんしゅけん	日本選手権
にほんせきじゅうじ	日本赤十字
にほんせいねんかん	日本青年館
にほんせいこうしょ	日本製鋼所
にほんすうがっかい	日本数学会
にほんじんせんしゅ	日本人選手
にほんじんがっこう	日本人学校
にほんじんがくせい	日本人学生
にほんじんかんとく	日本人監督
にほんじんいんせい	日本人院生
にほんじんいっぱん	日本人一般
にほんしゃけいけん	日本車経験
にほんしゃかいとう	日本社会党
にほんさいだいきぼ	日本最大規模
にほんごへんしゅう	日本語編集
にほんごぶんちゅう	日本語文中
にほんごぶんしょう	日本語文章
にほんごひょうげん	日本語表現
にほんごのうりょく	日本語能力
にほんごじまくばん	日本語字幕版
にほんごきょうほん	日本語教本
にほんごきょうしつ	日本語教室
にほんごかんきょう	日本語環境
にほんごかさぎょう	日本語化作業
にほんごかくちょう	日本語拡張
にほんごうせいごむ	日本合成ゴム
にほんこくけんぽう	日本国憲法
にほんこうかいばん	日本公開版
にほんぎんこうけん	日本銀行券
にほんきどうぶたい	日本機動部隊
にほんかんとうぐん	日本関東軍
にほんかいかいせん	日本海海戦
にほんかいえんがん	日本海沿岸
にほんえいたいぐら	日本永代蔵
にほんいりゅうみん	日本居留民
にほんいくえいかい	日本育英会
にほんいかだいがく	日本医科大学
にねんせいそうほん	二年生草本
にっぽんゆにばっく	日本ユニバック
にっぽんぶどうかん	日本武道館
にっぽんはつじょう	日本発条
にっぽんころむびあ	日本コロムビア
にっぽんこうかいじ	日本公開時
にっぽんぐんへいし	日本軍兵士
にっぽんぐんぶたい	日本軍部隊
にっぽんあすべすと	日本アスベスト
にっていちょうせい	日程調整
にっちょうかんけい	日朝関係
にっちゅうゆうこう	日中友好
にっちゅうそうほう	日中双方
にっちゅうせんそう	日中戦争
にっちゅうかんけい	日中関係
にっせいさんぎょう	日製産業
にっせいげきじょう	日生劇場
にっしんしょくひん	日清食品
にっさんじどうしゃ	日産自動車
にっこうしょうけん	日興証券	日興證券
にっこうきょうせき	日鉱共石
にっかんへいごうじ	日韓併合時
にっかんじょうやく	日韓条約
にっかんこうしょう	日韓交渉
にっかんこうぎょう	日刊工業
にっかんきょうてい	日韓協定
にっかつこうぎょう	日活興業
にちようびゆうがた	日曜日夕方
にちようだいくひん	日曜大工品
にちようしゅっきん	日曜出勤
にちようしゅくじつ	日曜祝日
にちようげきじょう	日曜劇場
にちよううんきゅう	日曜運休
にちょうけんじゅう	二挺拳銃
にちめんじつぎょう	日綿実業
にちべいこうしょう	日米交渉
にちべいきょうどう	日米共同
にちべいかんらくさ	日米間落差
にちだいつるがおか	日大鶴ヶ丘
にちじょうせいかつ	日常生活
にちじょうしゃかい	日常社会
にちじょうさはんじ	日常茶飯事
にちじょうぎょうむ	日常業務
にちじょうがいねん	日常概念
にちじょういっぱん	日常一般
にちげつかすいもく	日月火水木
にだいせいとうせい	二大政党制
にせんにんいじょう	二千人以上
にせたいじゅうたく	二世帯住宅
にじゅうとうひょう	二重投票
にじゅうせいきゅう	二重請求
にじゅういんようふ	二重引用符
にじゅういっせいき	二十一世紀
にじゅういちじょう	二一条
にじぶんれつそしき	二次分裂組織
にじとうごうしょり	二次統合処理
にじきおくばいたい	二次記憶媒体
にしやまぼくじょう	西山牧場
にしはちおうじえき	西八王子駅
にしはくしまちょう	西白島町
にしのみやきたぐち	西宮北口
にしにほんしんぶん	西日本新聞
にしにほんがくせい	西日本学生
にしにほんいちえん	西日本一円
にしざわじゅんいち	西澤潤一
にしこくらえきまえ	西小倉駅前
にしきがわてつどう	錦川鉄道
にしおせんけいとう	西尾線系統
にしおおじしじょう	西大路四条
にしおおじごじょう	西大路五条
にしあかしていしゃ	西明石停車
にこくかんきょうぎ	二国間協議
にくたいてきちから	肉体的力
にくたいてきくつう	肉体的苦痛
にくしょくどうぶつ	肉食動物
にくきりぼうちょう	肉切り包丁
にがおえたいしょう	似顔絵大賞
にかいどうこうこう	二階堂高校
なんりょうへんせい	何両編成
なんみんじょうやく	難民条約
なんぼくねつゆそう	南北熱輸送
なんぼくちょうせん	南北朝鮮
なんべいしゅうゆう	南米周遊
なんべいしゅうこう	南米就航
なんぶせんえんせん	南武線沿線
なんびゃくまんえん	何百万円
なんねんくらいまえ	何年位前
なんじゅっしゅるい	何十種類
なんじゅうまんまい	何十万枚
なんじゅうまんにん	何十万人
なんしょうなんぱい	何勝何敗
なんしゅうかんまえ	何週間前
なんこうがいびおん	軟口蓋鼻音
なんぎょうくぎょう	難行苦行
なんきんこうりゃく	南京攻略
なんきょくたいりく	南極大陸
なんきょくかんかい	南極環海
なんかいたかのせん	南海高野線
なんいどちょうせい	難易度調整
なりゆきちゅうもん	成行き注文
なりたしんかんせん	成田新幹線
なりたくうこうかん	成田空港間
なりたくうこうえき	成田空港駅
ならへいあんじだい	奈良平安時代	奈良・平安時代
ならせんきょうよう	奈良線共用
ならじょしだいがく	奈良女子大学
なまかいとうきのう	生解凍機能
ななじゅうねんだい	七十年代
なごやせいさくしょ	名古屋製作所
なごやけいばじょう	名古屋競馬場
なごやきゅうじょう	名古屋球場
なごやえきていしゃ	名古屋停車
ながらがわてつどう	長良川鉄道
ながはまていしょく	長浜定食
ながのにほんむせん	長野日本無線
ながのしんかんせん	長野新幹線
ながのしゃりょうく	長野車両区
ながたにえんほんぽ	永谷園本舗
ながさきけんちょう	長崎県庁
ながさきかようさい	長崎歌謡祭
なかみかどてんのう	中御門天皇
なかつがわりんどう	中津川林道
なかだちえいぎょう	仲立営業
なかたじまさきゅう	中田島砂丘
ないようしょうめい	内容証明
ないやおうえんだん	内野応援団
ないぶしょりそくど	内部処理速度
ないぶごういきげん	内部合意期限
ないぶこんごうしき	内部混合式
ないぶこうそうてき	内部抗争的
ないぶけつごうすう	内部結合数
ないせんでんわよう	内線電話用
ないせんでんわもう	内線電話網
ないせんじょうたい	内戦状態
ないせいせいちょう	内生生長
ないせいかんしょう	内政干渉
ないじゅうがいごう	内柔外剛
ないしきょうけんさ	内視鏡検査
ないかくふしんにん	内閣不信任
のりゆみのかえりだち	賭弓の還り立ち
のべやまてんもんだい	野辺山天文台
のうりょくこうじょう	能力向上
のうにゅうこくちしょ	納入告知書
のうにゅうぎょうしゃ	納入業者
のうぜいしんせいしょ	納税申請書
のうけつりゅうりょう	脳血流量
のうぎょうきほんほう	農業基本法
のうぎょういいんかい	農業委員会
のうがくけんきゅうか	農学研究科
ねんりょうでんちしゃ	燃料電池車
ねんぽうけいやくせい	年俸契約制
ねんびゃくねんじゅう	年百年中
ねんじゅうじゅうたい	年中渋滞
ねんしょうじょうたい	燃焼状態
ねんがじょうはいたつ	年賀状配達
ねつてんしゃほうしき	熱転写方式
ねつちゅうせいしそく	熱中性子束
ねつそんしつけいすう	熱損失係数
ねつかくはんのうだん	熱核反応弾
ねったいぎょかんけい	熱帯魚関係
ねっけつしゅじんこう	熱血主人公
ねがったりかなったり	願ったり叶ったり
にんていじっしゃばん	認定実写版
にんちてきとていせい	認知的徒弟制
にんちしんりがくてき	認知心理学的
にんちしんりがくしゃ	認知心理学者
にんちかがくせんしょ	認知科学選書
にんちかがくがっかい	認知科学学会
にんちかがくかいいん	認知科学会員
にんじゃぶげいちょう	忍者武芸帳
にんしょうほいくしょ	認証保育所
にんしょうだいめいし	人称代名詞
にんしきほうほうろん	認識方法論
にんしきかんいげんご	認識簡易言語
にんしきあやまりりつ	認識誤り率
にんげんひとりひとり	人間一人一人
にんげんてきよういん	人間的要因
にんげんてきみりょく	人間的魅力
にんげんこうがくてき	人間工学的
にんげんこうがくかい	人間工学会
にんぎょうちょうえき	人形町駅
にりんつうこうきんし	二輪通行禁止
にりんしゃかんきょう	二輪車環境
にらんせいそうせいじ	二卵性双生児
にゅうりょくりきりつ	入力力率
にゅうりょくもじすう	入力文字数
にゅうりょくほうほう	入力方法
にゅうりょくほうしき	入力方式
にゅうりょくへんかん	入力変換
にゅうりょくふかのう	入力不可能
にゅうりょくふぁいる	入力ファイル
にゅうりょくはいれつ	入力配列
にゅうりょくとちゅう	入力途中
にゅうりょくでんあつ	入力電圧
にゅうりょくたんまつ	入力端末
にゅうりょくせんたく	入力選択
にゅうりょくせってん	入力節点
にゅうりょくしんごう	入力信号
にゅうりょくさいぼう	入力細胞
にゅうりょくこうりつ	入力効率
にゅうりょくけいしき	入力形式
にゅうりょくくうかん	入力空間
にゅうりょくきりかえ	入力切替
にゅうりょくかんすう	入力関数
にゅうりょくおんあつ	入力音圧
にゅうよくりょうきん	入浴料金
にゅうよくはっぽうき	入浴発泡器
にゅうもんしょていど	入門書程度
にゅうもんきょういく	入門教育
にゅうせんはっぴょう	入選発表
にゅうじょうむりょう	入場無料
にゅうじょうせいげん	入場制限
にゅうじょうじんいん	入場人員
にゅうじょうしゃすう	入場者数
にゅうしょうさくひん	入賞作品
にゅうしゅつりょくぱ	入出力パターン
にゅうしゅつりょくち	入出力値
にゅうしゅかのうせい	入手可能性
にゅうこくしんさかん	入国審査官
にゅうこくかんりほう	入国管理法
にゅうきんかくにんご	入金確認後
にゅうがくねんがっぴ	入学年月日
にゅうがくきぼうしゃ	入学希望者
にゅうかじょうきょう	入荷情況
にゅうかいひむりょう	入会費無料
にゅうかいきぼうしゃ	入会希望者
にほんやっきょくほう	日本薬局方
にほんみこうかいさく	日本未公開作
にほんへんしゅうばん	日本編集盤
にほんぶつりがっかい	日本物理学会
にほんひょうろんしゃ	日本評論社
にほんひょうじゅんじ	日本標準時
にほんひょうじゅんご	日本標準語
にほんひかりがっかい	日本光学会
にほんはつとうじょう	日本初登場
にほんのうりんきかく	日本農林規格
にほんどうろこうだん	日本道路公団
にほんとうちゃくびん	日本到着便
にほんでんしんでんわ	日本電信電話
にほんでんしけいさん	日本電子計算
にほんちめいさくいん	日本地名索引
にほんだんじしっかく	日本男児失格
にほんたんぺんぶもん	日本短編部門
にほんじんがくぶせい	日本人学部生
にほんしんりがっかい	日本心理学会
にほんしゅっぱんしゃ	日本出版社
にほんさんだいとうげ	日本三大峠
にほんさいじょうりく	日本再上陸
にほんごへんかんよう	日本語変換用
にほんごにゅうりょく	日本語入力
にほんごてきかんかく	日本語的感覚
にほんごたいおうばん	日本語対応版
にほんこくどかいはつ	日本国土開発
にほんこくせきりだつ	日本国籍離脱
にほんこくけんぽうか	日本国憲法下
にほんこうぎょうだい	日本工業大
にほんげんごがっかい	日本言語学会
にほんぐんこくしゅぎ	日本軍国主義
にほんきょじゅうしゃ	日本居住者
にほんきょうさんとう	日本共産党
にほんきかいがっかい	日本機械学会
にほんかいじゅうかん	日本海縦貫
にほんかいがたきこう	日本海型気候
にほんえいがしじょう	日本映画史上
ににんしょうたんすう	二人称単数
にっぽんひゅーむかん	日本ヒューム管
にっぽんじんせんしゅ	日本人選手
にっぽんじんしんぱん	日本人審判
にっぽんこくけんぽう	日本国憲法
にっちゅうせんそうご	日中戦争後
にっかんこうそくせん	日韓高速船
にちようびじゅつかん	日曜美術館
にちべいだいがくせい	日米大学生
にちだいりこうでんし	日大理工電子
にちだいだいがくいん	日大大学院
にちだいせいさんこう	日大生産工
にちだいさくらがおか	日大桜ヶ丘
にちじょうしゅうかん	日常習慣
にそうしきせんたくき	二槽式洗濯機
にじょういんのさぬき	二条院讃岐
にじゅっさいいじょう	二十歳以上
にじゅうばしまええき	二重橋前駅
にじゅうすうねんまえ	二十数年前
にじゅうおくこうねん	二十億光年
にじてきちょさくぶつ	二次的著作物
にしみやきたぐちえき	西宮北口駅
にしはりだしせきわけ	西張出関脇
にしはりだしこむすび	西張出小結
にしにほんたんだいふ	西日本短大附	西日本短大付
にしにっぽりほうめん	西日暮里方面
にしなきねんざいだん	仁科記念財団
にしてつふくしません	西鉄福島線
にしてつおおむたせん	西鉄大牟田線
にししんじゅくしてん	西新宿支店
にしがわせんしんこく	西側先進国
にしがわじゆうせかい	西側自由世界
にしかるいざわちょう	西軽井沢町
にしかいがんおうふく	西海岸往復
にしおおじしちじょう	西大路七条
にくたいてきゆうえつ	肉体的優越
にくたいてきけっかん	肉体的欠陥
にかいせきしょうめん	二階席正面
にいがためいくんこう	新潟明訓高
にいがたてっこうしょ	新潟鉄工所
なんぼくりゅうりょう	南北流量
なんぼくせんかくえき	南北線各駅
なんべいきたはんぶん	南米北半分
なんねんなんがつごう	何年何月号
なんとうがたとうしゅ	軟投型投手
なんじゅうびょうかん	何十秒間
なんきょくじょうやく	南極条約
なんがつなんにちごう	何月何日号
なんかいきしかわせん	南海貴志川線
なりたくうこうちゃく	成田空港着
ななじょうかわらまち	七条河原町
なだこうとうがっこう	灘高等学校
なごやだいしょうてん	名古屋大賞典
なごやこうぎょうだい	名古屋工業大
なごやえいぎょうしょ	名古屋営業所
ながらがわかこうせき	長良川河口堰
ながのはらくさつぐち	長野原草津口
ながのじどうしゃどう	長野自動車道
ながさきでんききどう	長崎電気軌道
ながさきぞうせんじょ	長崎造船所
ながおかてんじんてん	長岡天神店
ながおかぎじゅつだい	長岡技術大
ながいきゅうぎじょう	長居球技場
なかやませいこうしょ	中山製鋼所
なかやまけいばじょう	中山競馬場
なかのおおえのおうじ	中大兄皇子
なかおがわてっきょう	中尾川鉄橋
ないようべつじっせき	内容別実績
ないぶじゅうりょくは	内部重力波
ないてききじゅんおん	内的基準音
ないちけんしゅういん	内地研修員
ないぞうろしゅつけい	内蔵露出計
ないざいてきせいしつ	内在的性質
ないこくさんしゅぼば	内国産種牡馬
ないかくそうじしょく	内閣総辞職
のりゆみのかえりあるじ	賭弓の還り饗
のりつぎわりびきせいど	乗継割引制度
のりつぎとっきゅうけん	乗継特急券
のうりんすいさんしょう	農林水産省
のうりんすいさんぎょう	農林水産業
のうりょくじょうしょう	能力上昇
のうぜいじゅんびよきん	納税準備預金
のうぜいしょうめいしょ	納税証明書
のうぎょうせいぶつけん	農業生物研
のうぎょうじゅうじしゃ	農業従事者
ねんりょうしょうひりつ	燃料消費率
ねんまつねんしきゅうか	年末年始休暇
ねんないうけつけちゅう	年内受付中
ねんかんこうどくりょう	年間購読料
ねぎししんりんこうえん	根岸森林公園
ねぎしけいばじょうあと	根岸競馬場跡
にんげんばんじさいおう	人間万事塞翁
にんぎょうはくぶつかん	人形博物館
にんいいんたいせんしゅ	任意引退選手
にゅうりょくりょういき	入力領域
にゅうりょくようりょう	入力容量
にゅうりょくべくとるち	入力ベクトル値
にゅうりょくぱらめーた	入力パラメータ
にゅうりょくでんりゅう	入力電流
にゅうりょくじょうほう	入力情報
にゅうりょくじょうたい	入力状態
にゅうりょくしゅうごう	入力集合
にゅうりょくごいっかつ	入力後一括
にゅうりょくきょくせん	入力曲線
にゅうりょくかんきょう	入力環境
にゅうもんてきこうえん	入門的講演
にゅうもんかいていばん	入門改訂版
にゅうじょうせいりけん	入場整理券
にゅうじょうけんきゃく	入場券客
にゅうしゅてはいちゅう	入手手配中
にゅうしゅつりょくよう	入出力用
にゅうしゅつりょくけい	入出力系
にゅうこくしんさりょう	入国審査料
にゅうこくかんりきょく	入国管理局
にゅうがくしゃぼしゅう	入学者募集
にゅうかいきんめんじょ	入会金免除
にほんろぼっとがっかい	日本ロボット学会
にほんゆうせいこうしゃ	日本郵政公社
にほんほうじんせつりつ	日本法人設立
にほんばしじょがっかん	日本橋女学館
にほんにんちかがくかい	日本認知科学会
にほんどうぶつがっかい	日本動物学会
にほんでんぱこうぎょう	日本電波工業
にほんでんねつがっかい	日本伝熱学会
にほんていこくこくみん	日本帝国国民
にほんたいいくだいがく	日本体育大学
にほんせきじゅうじしゃ	日本赤十字社
にほんすもうきょうかい	日本相撲協会
にほんすいろきょうかい	日本水路協会
にほんじんりょこうしゃ	日本人旅行者
にほんじんてきこうどう	日本人的行動
にほんじんじょうきゃく	日本人乗客
にほんじょしだいひょう	日本女子代表
にほんしょうぎれんめい	日本将棋連盟
にほんしゃかいぜんたい	日本社会全体
にほんこくみんぜんいん	日本国民全員
にほんこくないりょこう	日本国内旅行
にほんこくないはっこう	日本国内発行
にほんこうぶつがっかい	日本鉱物学会
にほんこうつうこうしゃ	日本交通公社
にほんこうそくつうしん	日本高速通信
にほんこうぎょうきかく	日本工業規格
にほんけんちくがっかい	日本建築学会
にほんけいざいしんぶん	日本経済新聞
にほんきかくきょうかい	日本規格協会
にほんがくじゅつかいぎ	日本学術会議
にほんかいようがっかい	日本海洋学会
にほんおんがくこうこう	日本音楽高校
にほんえんかきょうかい	日本煙火協会
にほんえいせいほうそう	日本衛星放送
にひゃくすうじゅうねん	二百数十年
にとうへんさんかっけい	二等辺三角形
にとうへんさんかくけい	二等辺三角形
にっちゅうりょこうしゃ	日中旅行社
にっちゅうさつえいよう	日中撮影用
にっしょうけんもんだい	日照権問題
にっしゃびょうかんじゃ	日射病患者
にっけいへいきんかぶか	日経平均株価
にっけいしんしゅんはい	日経新春杯
にちようだいくひんてん	日曜大工品店
にちべいぼうえきまさつ	日米貿易摩擦
にちべいちいきょうてい	日米地位協定
にちべいこうくうぼかん	日米航空母艦
にちだいりこうこうくう	日大理工航空
にちじょうてきがいねん	日常的概念
にじゅっせいきすうがく	二十世紀数学
にしわきじゅんざぶろう	西脇順三郎
にしゃたくいつかんけい	二者択一関係
にしのみやきゅうじょう	西宮球場
にしのみやきたぐちかん	西宮北口間
にしにほんじょうもんご	西日本縄文語
にしにほんきょうとせん	西日本京都線
にしなかじまみなみかた	西中島南方
にしとうきょうたいかい	西東京大会
にししんじゅくほうめん	西新宿方面
にしがわじゆうしゃかい	西側自由社会
にしかいがんりょうきん	西海岸料金
にくたいてきとくちょう	肉体的特徴
にくしょくきょうりゅう	肉食恐竜
にかんちゅうしんちゅう	二環中心柱
にいがただいしょうてん	新潟大賞典
なんみんきゅうさいじょ	難民救済所
なんぽうぐんしゅうだん	南方軍集団
なんべいしゅうゆうけん	南米周遊券
なんびゃくこうねんさき	何百光年先
なんきんだいぎゃくさつ	南京大虐殺
なんきょくかんそくたい	南極観測隊
なんきょくえっとうたい	南極越冬隊
なるときょうていじょう	鳴門競艇場
なりたくうこうもんだい	成田空港問題
なりたくうこうとうそう	成田空港闘争
ならこうぎょうこうせん	奈良工業高専
ながさきしゅっしんしゃ	長崎出身者
ながおかきょうほうめん	長岡京方面
なかやまだいしょうがい	中山大障害
ないぶぶんぴつこうぞう	内部分泌構造
ないぶひばくせんりょう	内部被曝線量
ないかくふしんにんあん	内閣不信任案
ないかくそうりだいじん	内閣総理大臣
のうりょくけんていしけん	能力検定試験
のうにゅうさきじゅうしょ	納入先住所
ねんりょうしょうひりょう	燃料消費量
ねんりょうしゅうごうたい	燃料集合体
ねんかんかっそうにっすう	年間滑走日数
ねつりきがくてきかんけい	熱力学的関係
ねつちゅうせいしかいせき	熱中性子解析
にんげんしゃかいせいぶつ	人間社会生物
にんききゅうじょうしょう	人気急上昇
にゅうりょくはんいしてい	入力範囲指定
にゅうりょくしゅうはすう	入力周波数
にゅうじょうきゃくぞうか	入場客増加
にゅうじとっぱつはっしん	乳児突発発疹
にゅうしゅつりょくりょう	入出力量
にゅうしゅつりょくぶぶん	入出力部分
にゅうしゅつりょくたんし	入出力端子
にゅうしゅつりょくそうち	入出力装置
にゅうしゅつりょくせっと	入出力セット
にゅうしゅつこくてつづき	入出国手続き	入出国手続
にゅうさんきんいんりょう	乳酸菌飲料
にゅうがくしけんもんだい	入学試験問題
にゅうかいもうしこみしょ	入会申込書
にほんりゅうせいがっかい	日本流星学会
にほんゆうせんたいしょう	日本有線大賞
にほんみはっぴょうきょく	日本未発表曲
にほんほうそうきょうかい	日本放送協会
にほんのうりつきょうかい	日本能率協会
にほんじんりゅうがくせい	日本人留学生
にほんじんけんきゅうしゃ	日本人研究者
にほんじんきょりゅうみん	日本人居留民
にほんじんかんこうきゃく	日本人観光客
にほんしんぶんきょうかい	日本新聞協会
にほんさんぎょうしんぶん	日本産業新聞
にほんごにゅうりょくほう	日本語入力法
にほんこくないたいしょう	日本国内対象
にほんこうぎょうだいがく	日本工業大学
にほんこうぎょうぎんこう	日本興業銀行
にほんけいえいきょうかい	日本経営協会
にほんきりすときょうだん	日本基督教団
にほんきしょうきょうかい	日本気象協会
にほんおんきょうがっかい	日本音響学会
にっぽんひゃくめいとうげ	日本百名峠
にっそきょうどうせんげん	日ソ共同宣言
にっけいしんぶんゆうかん	日経新聞夕刊
にっけいこうくうがいしゃ	日系航空会社
にちようようがげきじょう	日曜洋画劇場
にちべいとっきょもんだい	日米特許問題
にちべいこうぞうきょうぎ	日米構造協議
にちべいけいざいきょうぎ	日米経済協議
にちじょうてきびょうしゃ	日常的描写
にちじょうてきひょうげん	日常的表現
にちじょうせいかつじょう	日常生活上
にしゅつしゅうさんかじょ	二出集散花序
にしのみやきゅうぎじょう	西宮球技場
にしのみやきたぐちつうか	西宮北口通過
にしにっぽんがいしゃせん	西日本会社線
にいがためいくんこうこう	新潟明訓高校
なんねんなんがつなんにち	何年何月何日
なんきんぼうぎゃくじけん	南京暴虐事件
なんきんぎゃくさつじけん	南京虐殺事件
なごやこうぎょうだいがく	名古屋工業大学
なかのまつりごとのつかさ	中務省
なかじまひこうきがいしゃ	中島飛行機会社
のうどうおんじょうせいぎょ	能動音場制御
のうぜいしゃばんごうせいど	納税者番号制度
のうぎょうせいさんほうじん	農業生産法人
ねんしょうでんぱんこうりつ	燃焼伝搬効率
ねんかんそうこうにゅうがく	年間総購入額
ねんかんしょうひでんりょく	年間消費電力
にゅうしゅつりょくひどうき	入出力非同期
にゅうしゅつりょくぱたーん	入出力パターン
にゅうしゅつりょくとくせい	入出力特性
にゅうしゅつりょくかんけい	入出力関係
にゅうしゃしきろしゅつけい	入射式露出計
にゅうかいもうしこみちゅう	入会申込中
にほんぼうえきしんこうかい	日本貿易振興会
にほんちゅうおうけいばかい	日本中央競馬会
にほんごにゅうりょくちゅう	日本語入力中
にほんごにゅうりょくきこう	日本語入力機構
にほんごにゅうしゅつりょく	日本語入出力
にほんけいざいしんぶんしゃ	日本経済新聞社
にほんおんきょうがっかいし	日本音響学会誌
にっぽんじんけんきゅうしゃ	日本人研究者
にっぽんじんかんこうきゃく	日本人観光客
にっけいさんぎょうしんぶん	日経産業新聞
にっかんこうぎょうしんぶん	日刊工業新聞
にちべいこうくうきょうてい	日米航空協定
にちどくいさんごくどうめい	日独伊三国同盟
にちじょうてきじょうきょう	日常的状況
にちじょうせいかつぜんぱん	日常生活全般
にじょうてきしゅうかんせい	日常的習慣性
にしきょうごくきゅうじょう	西京極球場
なんみょうほうれんげきょう	南無妙法蓮華経
なんそうさとみはっけんでん	南総里見八犬伝
なんじゅっしゅうねんきねん	何十周年記念
なんきょくしゅうきょくいき	南極周極域
なむみょうほうれんげきょう	南無妙法蓮華経
ないようしょうめいゆうびん	内容証明郵便
ないかくかんぼうちょうかん	内閣官房長官
のうぎょうきょうどうくみあい	農業協同組合
にんちぶんさんしょりこうぞう	認知分散処理構造
にゅうりょくそうかんかんけい	入力相関関係
にゅうしゅつりょくひょうげん	入出力表現
にほんせいさくとうしぎんこう	日本政策投資銀行
にほんごにゅうりょくほうほう	日本語入力方法
にっちゅうきょうどうせいめい	日中共同声明
にちべいぎょうせいきょうてい	日米行政協定
にちべいきょうどうけんきゅう	日米共同研究
にちだいさくらがおかこうこう	日大桜ヶ丘高校
にしてつきたきゅうしゅうせん	西鉄北九州線
なんきょくしゅうきょくりゅう	南極周極流
のうぎょうさいがいほしょうほう	農業災害補償法
にゅうじょうりょうしゅうにゅう	入場料収入
にほんごにゅうりょくかんきょう	日本語入力環境
にっかんこうぎょうしんぶんしゃ	日刊工業新聞社
にっちゅうへいわゆうこうじょうやく	日中平和友好条約
にちべいかがくきょうりょくじぎょう	日米科学協力事業
にちべいかがくきょうどうけんきゅう	日米科学共同研究
にゅうようじとつぜんししょうこうぐん	乳幼児突然死症候群
にほんおんがくちょさくけんきょうかい	日本音楽著作権協会
ならせんたんかがくぎじゅつだいがくいんだいがく	奈良先端科学技術大学院大学